do n't underestimate my power . 	不要 小看 我 的 力量 。 
could you please talk a bit louder ? i ca n't hear very well . 	你 能 大聲 點 講 嗎 ？ 我 聽 不 太清 。 
now is the time to act . 	現在 是 行動 的 時候 了 。 
i was just talking about tom . 	我 僅僅 是 在 和 Tom 交談 。 
you have n't changed at all . 	你 真的 一點 沒變 。 
this is a beautiful flower . 	這是 一朵 美麗 的 花 。 
how much do you want in terms of salary ? 	您 想要 多少 工資 ？ 
she 's got a good eye for paintings . 	她 對 繪畫 有 很 好 的 鑑賞力 。 
everyone comes to tom for advice . 	每個 人 都 請 教湯姆 。 
one of the girls was left behind . 	這些 女孩 當中 其中 一個 被 留下 來 了 。 
i got it free . 	我 是 免費 得到 的 。 
i do n't believe the child came to tokyo alone . 	我 不 相信 孩子 能 獨自 到 東京 。 
there is n't anyone in the room . 	房間裡 沒有 任何人 。 
i will have finished reading this novel by the time you come tomorrow . 	你 明天 來 的 時候 ， 我 就 看 完 這本 小說 了 。 
i like may the best of all the months . 	所有 月份 中 我 最 喜歡 五月 。 
that 's a pencil . 	那 是 一支 鉛筆 。 
i caused him a lot of trouble . 	我給 他 帶 來 了 很多 麻煩 。 
he has no chance of succee@@ ding . 	他 沒 有 成功 的 機會 。 
he would often come to see us when i was a child . 	當我 還是 個 孩子 時 ， 他 經常來 看望 我們 。 
the teacher gave us homework . 	老師 給 我們 佈置 了 家庭 作業 。 
she put on socks . 	她 穿 上 襪子 。 
i 've got to go to the bank . 	我 必須 到 銀行 去 。 
i told you not to talk about the matter in her presence . 	我 跟 你 說 過 她 在 的 時候 不要 說 這件 事 。 
i spoke to tom last night . 	昨晚 我 和 湯姆 說話 了 。 
i ca n't understand how tom could know . 	我 不 懂 湯姆 怎麼 知道 的 。 
he is the rich@@ est man on earth . 	他 是 世界 上 最 有 錢 的 人 。 
tom sure talks a lot . 	湯姆 一定 很能 講 。 
let them learn from us . 	讓 他們 向 我們 學習 。 
do you know how to cook meat ? 	你 知道 怎麼 煮 肉 嗎 ? 
you do n't like gambling , do you ? 	你 不 喜歡 賭博 ， 是 嗎 ？ 
it 's just what i wanted . 	我 想要 的 就是 這個 。 
what i hate most of all is having to reci@@ te tex@@ ts from memory . 	我 最 討厭 背誦 課文 了 。 
i 'm here to as@@ sist you . 	我來 協助 你 。 
all of the milk was spilled . 	所有 的 牛奶 都灑 出去 了 。 
he likes anything sweet . 	他 喜歡 一切 甜 的 東西 。 
what is it that tom wants to eat ? 	湯姆 想 吃 的 是 什麼 ？ 
what do you like to do in your free time ? 	你 空閒 時間 喜歡 做 什麼 ？ 
what we had to do was really quite simple . 	我們 要 做 的 很 簡單 。 
if it is fine tomorrow , we 'll go on a picnic . 	如果 明天 天氣 好 ， 我們 就 去 野餐 。 
a truck was standing in the middle of the road . 	路 中間 有 一輛 卡車 。 
a fire broke out after the earthquake . 	地震 之後發生 了 火災 。 
tom plans to return . 	湯姆 打算 回來 。 
i would like to re@@ tract my pre@@ vious sta@@ te@@ ment . 	我 想 撤回 我 之前 的 陳述 。 
i prefer apples to oranges . 	比起 橘子 ， 我 更 喜歡 蘋果 。 
tom told me that he does n't like car@@ b@@ on@@ ated drinks . 	湯姆 告訴 我 他 不 喜歡 碳酸 飲料 。 
tri@@ m the fat off the meat . 	切除 這塊 肉 的 脂肪 。 
can i use my medical insurance ? 	我 可以 使用 我 的 醫療 保險 嗎 ？ 
do you drink a lot of milk ? 	你 喝 很多 牛奶 嗎 ？ 
of course . 	當然 。 
i got up early yesterday . 	昨天 我 很早 起牀 。 
i met her on a certain winter day . 	冬天 的 某日 ， 遇到 了 她 。 
he does n't know english at all . 	他 一點 也 不 懂 英語 。 
this is a very interesting book . 	這是 一本 非常 有趣 的 書 。 
have you seen my glasses anywhere ? 	你 曾 在 哪裡 看到 過我 的 眼鏡 嗎 ？ 
i just do n't want to lose you . 	我 只是 不想 失去 你 。 
did tom send you ? 	湯姆 派出 了 你 們 嗎 ？ 
the goods were tran@@ spor@@ ted by ship . 	這批 貨物 是 由 船 隻 運送 的 。 
what 's the name of this tune ? 	這歌 叫 什麼 名字 ？ 
you 've gained weight , have n't you ? 	你 的 體重 增加 了 ， 不是 嗎 ？ 
he was kind enough to take me to the hospital . 	他 好心 地 把 我 送到 醫院 。 
he is afraid of snakes . 	他 怕 蛇 。 
mary is n't really sick . she 's only pretending to be sick . 	瑪麗 不是 真病 。 她 只是 裝病 。 
why do n't you talk to him ? 	你 為 甚麼 不 跟 他講 ？ 
we had a rest in the sha@@ de . 	我們 在 樹蔭下 休息 。 
what were you doing in the at@@ tic ? 	你 在 閣樓 上 做 了 什麼 ？ 
please re@@ consider . 	請 重新 考慮 一下 。 
we want to know the facts . 	我們 想 知道 真相 。 
she was asked to convince him to get his son or someone else to paint the house . 	她 被 要求 去 說服 他 以 讓 他 或者 他 的 兒子 或者 是 別的 人來 粉刷 屋子 。 
you ca n't say no . 	你 無法 說 “ 不 ” 。 
when does the game begin ? 	遊戲 幾點 開始 ？ 
i arrived at n@@ ari@@ ta airport this morning . 	我 今天 早上 抵達 了 成田 機場 。 
work slowly . 	幹活 慢點 。 
school begins at 8@@ :30 a@@ .m . 	學校 8 點半 開始 上課 。 
tom had to go himself . 	湯姆 不得不 自己 去 。 
i called tom up . 	我 打 電話給 湯姆 了 。 
give me something to eat . 	給我點 東西 吃 。 
this is a picture of my sister . 	這是 我 姊 姊 的 照片 。 
she saw herself in the mirror . 	她 看到 鏡子裡 的 自己 。 
she left her son a lot of money . 	她 留 了 很多 錢 給 她 兒子 。 
i 'd like seats on the first floor . 	我 想要 一樓 的 座位 。 
a cat came out from under the desk . 	一 隻 貓從桌 底下 出來 。 
he calls her up every night . 	他 每天 晚上 打電話給 她 。 
turn off the light . 	關燈 。 
do i have to go to the party ? 	我 需要 去 派 對 嗎 ？ 
the old man walked across the road carefully . 	老人 小心翼翼 地過 了 馬路 。 
it 's none of your business . 	這不關 你 的 事 。 
do you think tom is weal@@ thy ? 	你 認為 湯姆有 錢 嗎 ？ 
do n't be afraid to make a mistake . 	別 害怕 犯錯 。 
i 'd rather you stayed at home . 	我寧願 你 待 在家 裡 。 
we had a mi@@ ld winter last year . 	去年 冬天 很 暖和 。 
is there an ap@@ p for that ? 	有 它 的 應用 嗎 ？ 
where is the book ? 	那 本書 在 哪兒 ？ 
what time does bo@@ ar@@ ding begin ? 	什麼 時候 開始 登機 ？ 
read as much as possible . 	盡 可能 地多 閱讀 書籍 。 
he is afraid of the dog . 	他 怕 那 只 狗 。 
can you see ? 	你 能 看 嗎 ？ 
will you all be here tomorrow ? 	明天 你 一整天 都 會 在 這裡 嗎 ? 
she had her hand@@ bag stolen . 	她 的 手提包 被 偷 了 。 
who else u@@ ses this room ? 	還有 誰 用 這個 房間 ？ 
a bridge was built across the river . 	人們 修 了 一座 橋過 河 。 
you look happy today . 	你 今天 看起 來 很 高興 。 
i really need to read all this . 	我 真的 需要 把 這 都 讀 了 。 
tom fell off his bicycle . 	湯姆 從 他 的 自行車 上 掉 了 下來 。 
we all have secrets . 	我們 都 有 祕密 。 
who does the cooking in your home ? 	你 家裏 誰 做飯 ？ 
stop foo@@ ling around . 	不要 隨便 開 玩笑 。 
it 's a new book . 	那本書 是 一本 新書 。 
the information is very important to us . 	這些 信息 對 我們 非常 重要 。 
he is a doctor by profession . 	他 的 職業 是 醫生 。 
all of a sudden , it began raining . 	突然 開始 下雨 。 
what subject do you like best ? 	你 最 喜歡 哪 一個 科目 ? 
tom drank my apple juice . 	Tom 喝 我 的 蘋 果汁 。 
you ought to get to work on time . 	你 應該 準時 上班 。 
english is just one of over 2@@ ,@@ 7@@ 00 languages in the world today . 	今天 ， 英語 只是 世界 上 超過 2 , 700 種語 言 的 其中 之一 。 
people of all ages like this song . 	這 首歌 老少 皆 宜 。 
english is spoken in america . 	在 美國 說 英語 。 
the post office is down the street . 	郵局 在 街 那頭 。 
do n't worry about it . 	不要 擔心 它 。 
she has lost weight . 	她 的 體重 減輕 了 。 
water is liquid . when it freezes , it becomes so@@ lid . 	水是 液體 。 凍 起來 就 成 了 固體 。 
the roses in the garden are bloo@@ ming . 	在 花園裡 的 玫瑰 正盛 開著 。 
the report is u@@ tterly false . 	這份 報告 完全 錯誤 。 
the end does not always justi@@ fy the means . 	為 了 正當 目的 並非 總是 可以 不擇 手段 . 
some boys came into the classroom . 	有些 男孩 走進 了 教室 。 
it 's a pity when somebody dies . 	有人 死 了 的 時候 真是 遺憾 。 
you had better get away from here at once . 	你 最好 立刻 離開 這裡 。 
i admire your courage . 	我 佩服 你 的 勇氣 。 
tom gave mary a nice present . 	湯姆給 了 瑪麗 一個 不錯 的 禮物 。 
do you still want to talk to me ? 	你 還 想 跟 我 談 嗎 ？ 
we are traveling on a tight bu@@ dget . 	我們 很 節省 地 旅行 。 
was this wall built to keep people out or to keep them in ? 	建造 這 堵牆 是 爲了 把 人 隔 在 外面 還是 把 他們 留在 裏面 ？ 
it was very nice seeing you again . 	非常 高興 再次 見 到 你 。 
please do n't ask . 	請 不要 問 。 
i do n't believe such things exist . 	我 不 相信 這樣 的 事情 存在 。 
what else have you figured out ? 	你 還 發現 什麼 了 ？ 
he has a wife and two young children to provide for . 	他 有 一個 妻子 和 兩個 孩子 要 養活 。 
finally , he achie@@ ved his goal . 	他 終於 達到 了 自己 的 目標 。 
i do n't want to hurt his feelings . 	我並 不想 傷害 他 的 感情 。 
i got your fa@@ x the other day . 	我前 幾天 收到 了 你 的 傳真 。 
she gave me a strange look . 	她 奇怪 地 看 了 我 一眼 。 
you 're working too hard . take it easy for a while . 	你 工作 太 勤奮 了 。 休息 一會 吧 。 
i lent him a cd . 	我 借給 他 一盤 CD 。 
how about going out for a walk ? 	出去 散步 怎麼樣 ？ 
tom did n't waste any time , did he ? 	湯姆 不浪費 一點 時間 ， 不是 麼 ？ 
god knows we did everything we could . 	上帝 知道 我們 做 了 我們 所能 做 的 事 。 
you should tell him the truth . 	你 該 告訴 他 真相 。 
ber@@ n is the capital of switzerland . 	伯恩是 瑞士 首都 。 
good evening . 	晚上 好 ！ 
i agree with him . 	我 同意 他 。 
i 'm sure i can find something for you to do . 	我 確定 我 能 找 點給 你 做 的 事 。 
this is not very sty@@ lish . 	這 不是 很 流行 。 
i 'll be free all day tomorrow . 	明天 我 一整天 都 有空 。 
please put on your shoes . 	請 穿 上 你 的 鞋子 。 
can i drive the tra@@ ctor ? 	我能 開 拖拉 機 嗎 ？ 
why should i thank tom ? 	我為 甚麼 該 感謝 湯姆 ？ 
you deserve the prize . 	你 應該 得到 這個 獎金 。 
he lives alone . 	他 一個 人 生活 。 
i got acquainted with him in france . 	我 在 法國 認識 了 他 。 
being sick is very boring . 	生病 很無聊 。 
tom did n't know what he 'd say to mary . 	湯姆 不 知道 他 要 對瑪麗 說 甚麼 。 
he placed the ladder against the fence . 	他 把 梯子 倚 著柵欄 放 。 
may i have a talk with you ? 	我能 和 你 談談 嗎 ？ 
if i had the money , i would immediately buy this computer . 	我 要是 有錢 ， 立馬 就 買 這臺 電腦 。 
she is qua@@ li@@ fied as a nurse . 	她 是 個 合格 的 護士 。 
his house was small and old . 	他 的 房子 又 小 又 舊 。 
i 'm so stupid . 	我 真蠢 。 
they called in a doctor because the child was ill . 	他們 打 電話給 醫生 因為 這個 孩子 生病 了 。 
you must do it . 	你 必須 去 做 。 
patience is sometimes the most effe@@ ctive weap@@ on . 	耐心 有時候 是 最 有效 的 武器 。 
your suggesti@@ on seems reasonable . 	你 的 建議 似乎 是 合理 的 。 
he told me he would go to ven@@ ice . 	他 告訴 過 我 他 會 去 威尼斯 。 
tom said he has n't decided what needs to be done . 	湯姆 說 他 還沒 決定 要 做 甚麼 。 
there is n't any so@@ a@@ p . 	沒有 任何 肥皂 。 
i do n't think he 'll come . 	我 不 認為 他 會 來 的 。 
do n't be afraid to make mistakes when speaking english . 	說 英語 的 時候 不要 怕 犯錯 。 
this is secret between you and me . 	這是 我們 之間 的 祕密 。 
people grow more cy@@ ni@@ cal with age . 	人會 隨著 年齡 的 增長 而 更加 地 玩世不恭 。 
you 're our only hope . 	你 是 我們 唯一 的 希望 。 
what size shoes do you wear ? 	你 穿 幾號 的 鞋子 ? 
i will badly miss you if you leave japan . 	如果 你 離開 日本 ， 我會 非常 想 你 的 。 
please turn off the television . 	請 把 電視關 掉 。 
i returned the knife which i had borrowed . 	我 把 我 借來 的 刀 還 了 。 
he is old enough to drive a car . 	他 的 年紀 可以 開車 了 。 
she has changed grea@@ tly since i last saw her . 	她 和 以前 比起 來變 了 很多 
may i see your bo@@ ar@@ ding pass , please ? 	請 讓 我 看看 您 的 登機證 好 嗎 ? 
tom is looking for a new job . 	湯姆 在 找 新 工作 。 
for the teacher , teaching her was fun . 	對 教師 來 說 ， 教 她 很 有趣 。 
these are cakes that she ba@@ ked herself . 	這些 是 她 自己 烤 的 蛋糕 。 
i 've already put tom to work on it . 	我 已經 讓 湯姆 去 做 它 了 。 
i think you know that 's not true . 	我 認爲 你 知道 那 不是 真的 。 
i 'm leaving for canada tomorrow . 	我 明天 要離 開去 加拿大 。 
let 's go as soon as it stops raining . 	只要 雨 一停 我們 就 走 。 
i wo n't talk to him anymore . 	我 不會 再 跟 他 說 話 了 。 
she was tired , but she kept working . 	她 累 了 ， 但 她 繼續 工作 。 
tell tom that i do n't need his help . 	告訴 湯姆 我 不 需要 他 的 幫助 ！ 
i had a telephone call from her . 	我 有 一通 來 自 她 的 電話 。 
it is two miles from here to the park . 	從 這裡 到 公園 距離 兩 英里 。 
he ran faster than his brother did . 	他 跑 得 比 他 哥哥 快 。 
that boy used to drop in on me . 	那 男孩兒 來訪 過 我家 。 
we played soccer yesterday . 	我們 昨天 踢 了 足球 。 
i 'm opposed to any type of war . 	我 反 對 任何 形式 的 戰爭 。 
who did you talk to ? 	你 和 誰 說話 呢 ？ 
i received an invitation . 	我 收到 了 一張 請帖 。 
tom is kind to everybody . 	湯姆 對 每個 人 都 好 。 
he is a good fel@@ low . 	他 是 個 好人 。 
he came to japan two years ago . 	他 兩 年前 來 日本 。 
tom has to do that right away . 	湯姆 必須 馬上 去 做 。 
tom would accept . 	湯姆會 接受 。 
which hat is yours ? 	哪頂 帽子 是 你 的 ？ 
this is uncle tom 's farm . 	這是 湯姆 叔叔 的 農場 。 
i 'm glad that i did n't buy something like this . 	我 很 高興 沒有 買 這樣 的 東西 。 
do you know how the accident happened ? 	你 知道 這個 意外 是 如何 發生 的 嗎 ？ 
tom drinks juice . 	Tom 喝 果汁 。 
there is a for@@ k missing . 	少 一把 叉子 。 
it 's clear that there 's a rather strong disa@@ gree@@ ment between the two . 	很明顯 的 是 這兩者 之間 有 很 強烈 的 分歧 。 
they wash their hands . 	他們 洗手 。 
years passed . 	多少 年 過去 了 。 
do you like any of these pictures ? 	你 喜歡 這些 畫裡 的 任何 一幅 嗎 ? 
even though i studied english for 6 years in school , i 'm not good at speaking it . 	儘管 我 在 學校 學了 6 年 英語 ， 我 還是 說 不好 。 
tom is no longer a member of this club . 	湯姆 不再 是 俱樂部 的 成員 了 。 
the old church by the lake is very beautiful . 	河邊 的 老 教堂 很 漂亮 。 
tom would n't hurt anyone . 	湯姆不會 傷害 任何人 。 
my vision is getting worse these days . 	這些 天 我 的 視力 正在 變差 。 
i wo n't work overtime today . 	今天 我 不 加班 。 
i 'll go with you as far as the bridge . 	我會 跟着 你 走 到 橋 那裏 。 
we are going downtown to eat pizza . 	我們 要 去 市中心 吃 比薩 。 
i passed the city hall on my way to the station . 	我 去 車站 的 路上 路過 了 市政 廳 。 
i feel sad every now and then . 	我 不時 地覺 得 難過 。 
let 's not waste time arguing about it . 	我們 別 再 浪費 時間 爭論 了 。 
this is a stupid de@@ sign . 	這份 設計 很蠢 。 
prices are going up . 	物價 上漲 了 。 
for here , or to go ? 	內用 還是 外帶 ? 
if you see a mistake , then please correct it . 	如果 你 發現 錯誤 ， 那 就 請 你 糾正 它 。 
my baggage is missing . 	我 的 行李 丟 了 。 
it 's already 7:00 . 	已經 是 早上 七點 了 。 
what kind of woman do you think i am ? 	你 認爲 我 是 哪種 女人 ？ 
that would be re@@ lev@@ ant . 	那會 有 關係 。 
i do n't know if he would have done it for me . 	我 不 知道 他 是否 已經 爲 我 做好 了 。 
i love my life . 	我 愛 我 的 生命 。 
spring is my favorite season . 	春天 是 我 最 喜愛 的 季節 。 
i 'm not feeling that hungry yet . 	我 感覺 還 不是 那麼 餓 。 
it 's almost time for the cherry blo@@ sso@@ ms . 	幾乎 是 櫻花 綻 放 的 時候 了 。 
is it ok if i go out with tom ? 	我 跟 湯姆 外出 行 嗎 ？ 
i ca n't stand this noise any longer . 	我無法 再 忍受 這個 噪音 了 。 
i need a pencil . can i use one of yours ? 	我 需要 一支 鉛筆 ， 我能 用 你 的 其中 一支 嗎 ？ 
let me read the paper when you have finished with it . 	報紙 看 完後 借 我 看 下 。 
she 's asking how that 's possible . 	她 問 這 怎麼 可能 。 
the city was destroyed by fire . 	這個 城市 毀 於 火災 。 
this is very good so@@ il . 	這是 非常 好 的 土壤 。 
how much time is left ? 	還 剩 多少 時間 ？ 
tom is an ex@@ tra@@ ordinary man . 	湯姆 是 個 不 尋常 的 人 。 
are you going to attend the meeting ? 	你 要 參加會議 嗎 ？ 
someone came . 	有人 來 了 。 
i do n't know where he lives . 	我 不 知道 他 住 在 哪裡 。 
could you show me this bag ? 	你 能給 我 看看 這個 包 嗎 ？ 
she got good grades in english . 	她 的 英文 成績 很 好 。 
give us a ride downtown . 	載 我們 到 市區 。 
i 'm proud of my son . 	我 爲 我 兒子 感到 驕傲 。 
our team lost all of its games . 	我們 的 隊伍 輸 了 所有 的 比賽 。 
he has a lot of money . 	他 有 很多 錢 。 
spring will come soon . 	春天 快來 了 。 
please drive the car more slowly . 	請 開車 開慢 一點 。 
i want to be a lawyer . 	我要 當律師 。 
tom 's birthday was yesterday . 	湯姆 的 生日 是 昨天 。 
do you know me ? 	你 認識 我 嗎 ？ 
he was wounded in the war . 	他 是 在 戰爭 中 受傷 的 。 
we know that all men are mor@@ tal . 	我們 知道 人 皆 難免 一死 。 
please think it over . 	請 考慮 一下 。 
please close the door quietly . 	請安靜 地 關門 。 
how soon can they be deli@@ ver@@ ed ? 	它們 什麼 時候 能 被 送到 ？ 
why do n't you go home ? 	你 爲什麼 不 回家 呢 ？ 
you should run for city coun@@ ci@@ l . 	你 應該 去 競選 城市 委員會 。 
she graduated from high school last year . 	去年 她 從 高中 畢業 了 。 
i work every day except sunday . 	我 除了 星期天 外 每天 都 上班 。 
i want to believe in tom . 	我要 相信 湯姆 。 
how many friends do you have ? 	你 有 多少 朋友 ？ 
they want this . 	他們 想要 這個 。 
she left here right away . 	她 馬 上 離開 了 這裡 。 
i made several mistakes in the exam . 	在 這次 考試 中 我 犯 了 幾個 錯誤 。 
she for@@ gave the boy for his rudeness . 	她 原諒 了 男孩 的 粗魯 。 
she is very pretty . 	她 很 可愛 。 
that 's the chair that i really like . 	那 是 我 真的 很 喜歡 的 椅子 。 
the company went bankrupt . 	公司 破產 了 。 
i need to get a stamp . 	我 需要 一張 郵票 。 
i did n't see him . 	我 沒 見到 他 。 
he gave it to me for nothing . 	他 免費 把 它給 了 我 。 
what tom said does n't appl@@ y in this situation . 	湯姆 所言 不符 時局 。 
i hear he is good at mahjong . 	我 聽說 他 打 麻將 很 厲害 。 
sit beside me . 	坐 我 旁邊 。 
he pretended not to be listening . 	他 裝作 沒 在 聽 。 
he has not been to france . 	他 從沒 去過 法國 。 
i ca n't get away from work now . 	我現 在 上班 無法 離開 。 
do n't move , or i 'll shoot you . 	別動 ， 不然 我 就 開槍射 你 。 
they looked as if they would cry . 	他們 看 起來 好像 要 哭 了 。 
there is a basket under the table . 	桌子 底下 有 一個 籃子 。 
tom made some mistakes on the test . 	湯姆 在 考試 中犯 了 一些 錯誤 。 
what is your opinion on this matter ? 	關於 那個 你 有 什麼 看法 ？ 
one of them is a sp@@ y . 	他們 其中 一人 是 間諜 。 
she is now staying at her uncle 's house . 	她 現在 正待 在 她 叔叔 家 。 
she is fond of playing tennis . 	她 酷愛 打 網球 。 
they stole apples from my or@@ c@@ hard . 	他們 從 我 的 果園 偷 了 蘋果 。 
he makes it a rule to take a walk every morning . 	他 給 自己 定下 每天 早上 散步 的 規矩 。 
there 's no way to know . 	沒有 辦法 知道 。 
the sky is full of dark clouds . 	天空 烏雲密佈 。 
o@@ ga@@ i is his favorite author . 	Ogai 是 他 最 喜歡 的 作者 。 
she 'll love her husband forever . 	她 會永遠 愛 她 的 丈夫 。 
you speak good english . 	你 的 英語 說 得 很 好 。 
many thanks . 	非常 感謝 ！ 
tom is very coura@@ ge@@ ous , is n't he ? 	湯姆 非常 勇敢 ， 不是 麼 ？ 
tom showed us his new car . 	湯姆給 我們 看 他 的 新車 。 
i 'd rather stay at home . 	我寧願 待 在家 裡 。 
have you ever seen tom when he 's angry ? 	你 有 看見 過 湯姆生 氣 的 時候 嗎 ？ 
many people were killed in the war . 	很多 人 在 戰爭 中 被 殺 。 
perhaps he missed the train . 	他 可能 錯過 了 火車 。 
help me lift the package . 	幫 我 擡起 這 包裹 。 
do n't be so carele@@ ss ! 	別 這麼 粗心 ！ 
how was your trip ? 	你 的 旅行 怎麼樣 ? 
there are a lot of books in the library . 	圖書館裡 有 很多 書 。 
i am lost . can you help me , please ? 	我 迷路 了 ， 能 不能 請 您 幫 我 一下 ？ 
speaking english is very difficult for me . 	說 英語 對 我 來 說 很 困難 。 
the lake is deepest at this spo@@ t . 	這裏 是 湖 最深 的 地方 。 
what 's the exchange rate today ? 	今天 的 匯率 是 多少 ？ 
i can only speak for myself . 	我 只能 代表 我 自己 講話 。 
she felt blue . 	她 感到 悶悶不樂 的 。 
everybody knows that he is honest . 	大家 都 知道 他 是 誠實 的 。 
give me something to write on . 	給我 一些 我 可以 在 上面 寫字 的 東西 。 
such a thing ca n't happen in japan . 	這樣 的 事情 不 可能 在 日本 發生 。 
the train arrived on schedule . 	火車 準時 到 了 。 
i understood everything tom said . 	我 明白 湯姆 所 說 的 一切 。 
this job pa@@ ys 10,000 yen a day . 	這個 工作 一天 有 10 , 000 日圓 的 報酬 。 
tom did n't know how to translate the word `` computer '' because the people he was talking to had never seen one . 	湯姆 不知 如何 翻譯 “ 計算機 ” 一詞 ， 因爲 同 他 談話 的 人 從未 見過 一臺 。 
this is a wooden table . 	這 是 張 木桌 。 
the days are getting longer and longer . 	白天 漸漸 地 越來 越長 。 
you are no longer a m@@ ere child . 	你 不再 只是 一個 孩子 了 。 
tom says he 's tired . 	湯姆 說 他 累 了 。 
i love this song . 	我 愛 這 首歌 。 
he was born in africa . 	他 出生 在 非洲 。 
i hope that your brother is better . 	我 希望 你 弟弟 好點 了 。 
i know him by name , but not by sight . 	我 知道 他 的 名字 ， 但 不 知道 他長 什麼樣 。 
i 'd wear a hel@@ met . 	我要 戴頭 盔 。 
i kind of lost my focus . 	我 有點 不能 集中 注意力 。 
you should do the hon@@ or@@ able thing and resign . 	你 應該 光榮 地 辭職 。 
whose is it ? 	這 是 誰 的 ？ 
he 's just gone on leave . 	他剛 請 假 走 了 。 
go away ! 	走開 ！ 
prices have dropped recently . 	最近 物價 已經 下降 。 
you had better be careful not to over@@ eat . 	你 最好 小心 不要 吃 過量 。 
stick with it and you 'll succeed . 	堅持 下來 ， 你 就 能 成功 。 
the boy who lives next door often comes home late . 	隔壁 的 男孩 常常 晚 回家 。 
i just could n't say no . 	我 就是 不能 說 不 。 
he left his son a large fortune . 	他 留給 了 他 的 兒子 一大 筆財富 。 
tom has a lot to think about . 	湯姆 要 考慮 很多 。 
my right hand is numb . 	我 的 右手 麻 了 。 
how about going out for dinner ? 	出去 吃 晚餐 如何 ？ 
i know how to make beef stro@@ g@@ an@@ off . 	我 知道 怎麼 做 俄式 炒 牛肉 片 。 
is tom a good guy ? 	湯姆 是 好人 。 
tom still drinks , but not as much as he used to . 	湯姆 還是 喝 ， 但 不 像 以前 那麼 多 了 。 
are you writing a letter ? 	你 在 寫信 嗎 ？ 
tom did well considering his age . 	考慮 到 他 的 年紀 ， 他 做 得 很 好 。 
the a@@ verage height of the girls in class is over 1@@ 5@@ 5 centi@@ meters . 	這個 班 的 女生 平均 身高 超過 了 155 公分 。 
welcome . 	歡迎 。 
i have to cook dinner today . 	我 今天 要 準備 晚飯 。 
he will be back soon . 	他 很快 就 會 回來 的 。 
is this your family ? 	這 是 你 的 家人 嗎 ？ 
tom has no one to turn to for help . 	湯姆 沒有 能 求助 的 人 。 
tom is n't complaining . 	湯姆 沒有 抱怨 。 
the girl was sobbing in the corner of the sch@@ oo@@ l@@ room . 	女孩 在 教室 的 角落 啜泣 。 
we love tom . 	我們 愛 湯姆 。 
do you get up at six ? 	你 六點 起牀 嗎 ？ 
tom is a native french speaker . 	湯姆 是 法語 母語 者 。 
he is not as smart as his older brother . 	他 不 像 他 的 兄長 那樣 聰明 。 
you must be at the station by 5 o'clock . 	五點 以前 你 必須 在 車站 。 
it 'll cost at least five dollars . 	它 至少 要花 五 美元 。 
where 's the boss ? 	老 闆 在 哪裡 ？ 
tom used to work here . 	湯姆 過去 在 這裏 工作 。 
i 'm willing to share . 	我 樂意 分享 。 
he does n't live there anymore . 	他 不再 住 在 這裡 了 。 
you ca n't count on their help . 	你 不能 指望 他們 的 幫助 。 
man can not live forever . 	人 無法 長生不死 。 
i 'd like to have this meat dish with your best white wine . 	我 想 在 吃 這肉 喝 你 最好 的 白酒 。 
i live in a big city . 	我 住 在 一個 大城市 裏 。 
she 'll give her photo to whoever wants it . 	她 會 把 她 的 照片 給 想要 的 人 。 
could you say that in plain english ? 	你 會 說 簡單 的 英語 嗎 ？ 
i feel bad enough already . 	我 已經 感覺 夠 壞 了 。 
my shoulder really a@@ ches . 	我 的 肩膀 很 痠 。 
i 'll attend the meeting . 	我將 參加 這個 會議 。 
they gave us very little trouble . 	他們 幾乎 不給 我們 添麻煩 。 
let 's go and swim in the river . 	讓 我們 去 河裡 游泳 吧 。 
tom was all wor@@ n out . 	湯姆 完全 筋 疲力 盡 了 。 
they are much taller than us . 	他們 比 我們 高得 多 。 
this is n't what i ordered . 	這 不是 我點 的 食物 。 
tom wrote a letter to mary this morning . 	Tom 今天 早上 寫 了 封信 給 Mary 。 
this is my mother . 	這 是 我 母親 。 
please come over if you have time . 	如果 你 有 時間 的 話 ， 請過 來 一趟 。 
i always rely on him in times of trouble . 	我 在 困難 時 總 是 依賴 他 。 
sorry , but can you show me the way to the next village ? 	能 不能 麻煩 你 告訴 我 去 鄰村 怎麼 走 ？ 
once again . 	再 一次 。 
she always gets her own way . 	她 總 是 隨心 所欲 。 
we know everything . 	我們 什麼 都 知道 。 
we 'll take part in the mar@@ a@@ th@@ on . 	我們 將 參加 馬拉松 。 
i like wearing long skirts . 	我 喜歡 穿長 襪 。 
try to keep from crying . 	試著 不要 哭 。 
were you in boston last summer ? 	你 上 個 夏季 在 波士頓 嗎 ？ 
be@@ e@@ tho@@ ven was a great musi@@ cian . 	貝多芬 是 一個 偉大 的 音樂家 。 
she de@@ cor@@ ated her room with roses . 	她 用 玫瑰花 裝飾 了 她 的 房間 。 
they both cried after hearing the tra@@ gic news . 	聽到 這件 悲劇 ， 他 倆 盡 皆 哭泣 。 
my father is too busy to take a walk . 	我父 親太忙 而 無法 去 散步 。 
what will tomorrow 's weather be like ? 	明天 天氣 怎麼樣 ？ 
i forgot . 	我 忘 了 。 
see you at the party . 	在 派 對 上 見 。 
she has a strong wish to work as an interpreter . 	她 非常 想當 口譯 。 
i made other plans . 	我 另 有 計劃 。 
she does n't like people who are n't punctual . 	她 不 喜歡 不 守時 的 人 。 
the soldiers are ready for battle . 	士兵 們 準備 好 要 戰鬥 了 。 
tell me about some of the places you 've visited . 	給 我 說 說 你 去過 的 一些 地方 。 
i belong to the swimming club . 	我 是 游泳 社的 成員 。 
we 'll talk about this later . 	我們 晚會 再 談 這事 。 
let 's walk . 	我們 走走 吧 。 
this medicine will help you . 	這個 藥會 幫助 你 。 
i ate breakfast in my pa@@ ja@@ mas . 	我 穿 著 我 的 睡衣 吃 早餐 。 
you should have warned him sooner . 	你 應該 要 更 快 警告 他 的 。 
it 's improved . 	它 有 改善 了 。 
i heard him coming down@@ stairs . 	我 聽 見 他 下樓 的 聲音 。 
this desk takes up too much room . 	這張 桌子 太 佔 空間 了 。 
he lives across the street from us . 	他 住 在 我們 街 對面 。 
you may come if you like . 	如果 你 想 ， 你 可以 來 。 
does anyone here know where tom lives ? 	這裡 有人 知道 湯姆住 在 哪裡 嗎 ？ 
i want you to go . 	我要 你 去 。 
what 's today 's date ? 	今天 幾號 ？ 
he taught himself french . 	他 自學 法語 。 
this writer is russian . 	這個 作家 是 俄羅斯 人 。 
he 's busy with his homework now . 	他現 在 正忙 著 做 他 的 家庭 作業 。 
where is the vodka ? 	伏特加 在 哪裏 ？ 
tom has n't lost his confidence . 	湯姆還 沒有 失去 信心 。 
i saw a cat running after the dog . 	我見 一隻 貓 追 着 狗 跑 。 
they have nothing to eat . 	他們 沒有 東西 吃 了 。 
tom searched inside the closet . 	湯姆 搜查 了 衣櫃 裏面 。 
tom got a late start this morning . 	湯姆 今早 出發 晚 了 。 
tomorrow 's weather should be sun@@ ny with occasion@@ al rain . 	明天 天氣 晴轉 陣雨 。 
i read a book last night . 	我 昨晚 讀書 。 
i must re@@ pay the debt . 	我 必須 償還 債務 。 
we 're fighting against time . 	我們 在 跟 時間 鬥爭 。 
i just got your letter yesterday . 	我 昨天 剛 收到 你 的 信 。 
we just need a plan . 	我們 只是 需要 個 計畫 。 
tom has been learning french for a few years . 	湯姆 學了 幾年 法語 。 
this directly concer@@ ns you . 	這 與 你 有 直接 關係 。 
i have a sore throat . 	我 喉嚨 痛 。 
she returned the book to the library . 	她 把 書 還給 了 圖書館 。 
is that your car ? 	那 是 你 的 車嗎 ? 
i bet ten dollars on that horse . 	我 在 那匹馬 下 十 美元 的 賭注 。 
he is rotten to the cor@@ e . 	他壞 透 了 。 
how lovely ! 	多 可愛 啊 ！ 
quite a few americans like sushi . 	不少 的 美國 人喜 歡壽司 。 
we 're not in boston . 	我們 不 在 波士頓 。 
ca n't you discount it a little ? 	你 不能 打一點 折 嗎 ？ 
tom just got divorced , too . 	湯姆 也 剛離婚 。 
we 're nex@@ t-@@ door neighbors . 	我們 是 隔 着 牆 的 鄰居 。 
i do n't care if it snows . 	我 不在乎 是否 下雪 。 
i have a daughter . 	我 有 一個 女兒 。 
i refuse to be treated like a child . 	我 拒絕 被 像 一個 孩子 般 對待 。 
do you believe what he said ? 	你 相信 他 說 的 話 嗎 ？ 
turn right . 	向 右 轉 。 
i received her letter yesterday . 	昨天 我 收到 了 她 的 信 。 
i did n't even know tom had left . 	我 甚至 不 知道 湯姆離 開 了 。 
it was mar@@ i@@ e curi@@ e who discovered radi@@ um . 	鐳 是 居里夫人 所 發現 的 。 
where would you like to go first ? 	你 想 先去 哪裡 ? 
soccer is my favorite sport . 	足球 是 我 最 喜歡 的 運動 。 
i have breakfast at seven . 	我 在 七點 吃 早飯 。 
take it easy . 	放 輕 鬆 。 
one of my suit@@ ca@@ ses is missing . 	我 的 其中 一個 行李 不見 了 。 
tom had a lot of problems at the school . 	湯姆 在 學校 遇到 了 很多 問題 。 
send for a doctor at once . 	立即 送醫 。 
i wonder why kar@@ a@@ o@@ ke is so popular . 	我 不 知道 為 什麼 卡拉 OK 如此 受歡 迎 。 
it 's already nine o'clock . 	已經 9 點 了 。 
open your mouth and close your eyes . 	張開 嘴巴 閉上 眼睛 。 
she decl@@ ared that she was not guilty . 	她 聲稱 自己 沒罪 。 
you 're quite forge@@ tful . 	你 很 健忘 。 
i 'm a free man . 	我 是 一個 自由 的 人 。 
i 've heard that name somewhere before . 	我 在 別處 聽過 那個 名字 。 
tom asked mary where she 'd put the key . 	湯姆 問瑪麗 她 把 鑰匙 放在 哪裡 了 。 
it 's ok not to eat it . 	你 不吃 沒關 係 。 
she cleaned her room in a hurry . 	她 急忙 地清 掃 了 她 的 房間 。 
he has plenty of money in the bank . 	他 在 銀行 裏 有 大量 錢財 。 
they sometimes help us . 	他們 有 時 幫 我們 。 
thank you for invi@@ ting me to dinner . 	謝謝 你 邀請 我 吃飯 。 
you 'd better not see her now . 	你 最好 不要 再見 她 了 。 
i think i understand . 	我 想 我 懂 了 。 
it is less mu@@ g@@ gy today than it was yesterday . 	今天 不比 昨天 悶熱 。 
you look stupid . 	你 看上去 很 傻 。 
old people get up very early . 	老人 們 很 早就 起牀 。 
it 's obvious why his stomach hurts . 	他 為 什麼 會 胃痛 的 原因 很明顯 。 
broccoli is one of the healthiest vegetables . 	西藍花 是 最 健康 的 蔬菜 之一 。 
how tall are your parents ? 	你 的 父母 有 多 高 ？ 
we had a heavy rain last night . 	昨晚 下 了 一場 大雨 。 
bird watching is a nice hobby . 	觀察 鳥類 是 個 很 好 的 業餘 愛好 。 
the prince fell in love with a woo@@ d@@ cu@@ tter 's daughter . 	王子 愛上 了 一個 樵夫 的 女兒 。 
i 've always wanted to do that . 	我 一直 都 想 做 。 
the apple was eaten by me . 	我 吃 蘋果 。 
chinese is a to@@ nal language . 	漢語 是 一個 聲調 語言 。 
i was n't alone then . 	我 當時 不 孤單 。 
it is more ble@@ ssed to give than to receive . 	贈與 比 接受 更 讓 人 覺得 幸福 。 
you can swim , ca n't you ? 	你 會 游泳 , 不是 嗎 ？ 
i can cook you something if you 're hungry . 	要是 你 餓 了 ， 我能 給 你 做飯 。 
there was no money for re@@ building . 	沒有 重建 的 錢 。 
all their secrets have been re@@ v@@ ea@@ led . 	他們 所有 的 祕密 都 已經 被 揭曉了 。 
mary grabbed her purse and left . 	Mary 霸佔 了 她 的 包包 並且 離開 了 。 
i got my hair cut . 	我 把 我的頭 髮 剪 了 。 
he is un@@ fit to be a teacher . 	他 不 適合 當 老師 。 
they never give up . 	他們 永不 言棄 。 
children sometimes lack patience . 	孩子 通常 沒有 耐心 。 
that meat is chicken . 	那個 肉 是 雞肉 。 
he 's accustomed to traveling . 	他 習慣 了 旅行 。 
how interesting ! 	多麼 有趣 啊 ！ 
i just ate sushi and drank beer . 	我剛 才 吃 了 壽司 喝 了 啤酒 。 
have you ever climbed mt . yar@@ i ? 	你 曾 爬 過槍嶽 嗎 ? 
we work in a factory . 	我們 在 一個 工廠 工作 。 
tom wants to talk . 	湯姆 想 說話 。 
you should drink a lot of liquid . 	你 應該 喝 大量 的 液體 。 
there was no water in the well . 	這口 井裡 沒 有 水 。 
the boy is kind . 	他 是 個 好孩子 。 
i am thinking of going abroad . 	我 在 考慮 出國 。 
you 're still too young to get a driver 's license . 	你 還太年 輕無法 取得 駕駛 執照 。 
my shoulder hurts . 	我 肩膀 痛 。 
wo n't you have some coffee ? 	你 不要 點 咖啡 嗎 ？ 
tom wanted re@@ ven@@ ge . 	湯姆想 報仇 。 
people ca n't live forever . 	人 無法 長生不死 。 
tom does n't believe he could do that . 	湯姆 不 相信 他 能 做到 。 
tom told me to take good care of myself . 	湯姆 告訴 我要 照顧 好 我 自己 。 
swi@@ tch on the light . i ca n't see anything . 	把 燈 打開 。 我 什麼 都 看 不見 了 。 
they have an@@ nounced their enga@@ gement . 	他們 已經 宣佈 訂婚 了 。 
the dress fits you very well . 	這條 裙子 你 穿着 很 合身 。 
we have no time . 	我們 沒 時間 。 
let your uncle think about it . 	讓 你 叔叔 想 一想 。 
i hope tom 's pre@@ dicti@@ ons are wrong . 	我 希望 湯姆 的 預測 是 錯 的 。 
are you coming tomorrow ? 	你 明天 要來 嗎 ？ 
i just do n't like it . 	我 只是 不 喜歡 它 。 
i thought the questions were easy . 	我 認為 這些 問題 很 容易 。 
he speaks french fluently . 	他 說 法語 說 得 很 流利 。 
follow me . 	請 跟 我 來 。 
how do you pronounce your name ? 	你 怎麼 唸 你 的 名字 ？ 
leaves begin to fall in october . 	樹葉 在 十月 開始 掉落 下來 。 
he came to my rescu@@ e . 	他 拯救 了 我 。 
i have a feeling he is right . 	我覺 得 他 是 對 的 。 
he told us such a funny story that we all laughed . 	他 給 我們 講 了 一個 有趣 的 故事 ， 我們 都 笑 了 起來 。 
she did n't think so . 	她 不 這麼 想 。 
i can help you out . 	我能 幫 你 。 
put it out of your mind . 	別去 想 它 。 
i think that it 's true . 	我 認為 這是 真的 。 
cooki@@ e 's mother died of cancer . 	Cookie 的 母親 死 於 癌症 。 
i 'm sure tom ca n't swim . 	我 確定 湯姆 不會 游泳 。 
would you lend me your bicycle ? 	你 可以 借 我 你 的 腳踏車 嗎 ? 
do you have medical insurance ? 	你 有 醫療 保險 嗎 ？ 
she lives in a t@@ wo@@ -@@ story house . 	她 住 在 一棟 兩層 樓 的 房子 。 
i do n't feel well . 	我 感覺 不 舒服 。 
i agree completely . 	我 完全 同意 。 
she cried when she heard the news . 	當 她 聽 到 這個 消息 的 時候 ， 她 哭 了 。 
tom s@@ nea@@ ked up behind mary . 	湯姆 鬼鬼祟祟 地 遛 近 了 瑪麗 身後 。 
let me in . 	讓 我 進去 。 
let 's go now . 	我們 現在 去 吧 。 
english is taught in most countries . 	英語 在 大部份 的 國家 被 教授 。 
i 'll be back late . 	我會 晚一點 回來 。 
my school is on the left . 	我 的 學校 在 我家 左邊 。 
i plan to stay at home all day tomorrow . 	我 打算 明天 在 家裏 待 一天 。 
did you remember that you were supposed to buy can@@ dles ? 	你 記得 自己 該 買 蠟燭 嗎 ？ 
i 'm sa@@ ving up to buy a new car . 	我 在 省錢 買 新車 。 
there was no water in the river . 	河裡 沒 有 水 了 。 
she gave me a mean@@ ing@@ ful look . 	她 意味 深長 地 看 了 我 一眼 。 
i have nothing to complain about . 	我 沒 有 什麼 可 抱怨 的 。 
smoking is not permi@@ tted on the train . 	不允許 在 火車 上 吸煙 。 
everything went black . 	一切 都 變成 了 黑色 。 
i want to buy something to eat . 	我想 買點 東西 吃 。 
i want you to tell me the truth . 	我 想 你 把 真相 告訴 我 。 
he never looks down on poor people . 	他 從 未 看不起 窮人 。 
would you please wait for a few minutes ? 	請 您 等 幾分鐘 好 嗎 ？ 
she is already sleeping . 	她 已經 睡下 了 。 
this book of his is n't interesting at all . 	他 的 這 本書 一點 意思 也 沒有 。 
i do n't know whether i have time or not . 	我 不 知道 有沒有 時間 。 
do you not understand basic logic ? 	你 不 懂 基本 邏輯 嗎 ？ 
i wake him up at 6 every morning . 	我 每天 早上 6 點 叫醒 他 。 
i do n't have a car . 	我 沒 有 汽車 。 
it is clear what must be done . 	顯然 地勢 必要 做些 什麼 。 
i ca n't help feeling sorry for him . 	我 不禁 為 他 感到 難過 。 
his letter makes me un@@ easy . 	他 的 來信 讓 我 不安 。 
we should call the police . 	我們 該 報警 。 
that wo n't ever happen . 	那 從 不會 發生 。 
what 's the last thing you remember ? 	你 能記 起來 的 最後 一件 事是 什麼 ？ 
she 's just a child . 	她 只是 個 孩子 。 
his father dedicated his life to science . 	他 的 父親 把 一生 奉獻給 了 科學 。 
tom is on the bus to the city . 	湯姆 搭公車 去 市區 。 
we 're not looking . 	我們 沒有 看著 。 
beer bottles are made of glass . 	啤酒瓶 是 玻璃 做 的 。 
she and i are brother and sister . 	我 和 她 是 兄妹 。 
you should have done so . 	你 本應 該 這樣 做 的 。 
let 's go to the hospital now . 	我們 現在 就 去 醫院 吧 。 
please open the bottle . 	請 打開 瓶子 。 
how long are you going to stay in japan ? 	你 會 在 日本 多久 ? 
my wish is to become a teacher . 	我 的 願望 是 成為 一個 老師 。 
i do n't like science . 	我 不 喜歡 科學 。 
this dictionary is mine . 	這本 字典 是 我 的 。 
the students have returned . 	學生 們 回來 了 。 
she and i have nothing in common . 	我 和 她 沒 有 共同 之處 。 
i agree with your opinion . 	我 同意 您 的 意見 。 
it does n't surprise me . 	這 並 不讓 我 驚訝 。 
you know i 'm right . 	你 知道 我 是 正確 的 。 
i am in trouble . 	我 有 麻煩 了 。 
tom left his umbrella on the bus . 	湯姆 把 傘 落 在 了 巴士 上 。 
he wears glasses . 	他 戴 眼鏡 。 
the car is waiting at the gate . 	車在 門口 等 著 。 
they were always making jokes . 	他們 一直 鬧笑話 。 
we 'll have lived here for two years next april . 	到 明年 四月 我們 住 在 這兒 就 滿 兩年 了 。 
our baseball team is very strong . 	我們 的 棒球 隊 很強 。 
nothing is missing . 	什麼 也 沒少 。 
i guess that would be all right . 	我 猜 那 應該 可以 的 。 
the things he says are enti@@ rely in@@ con@@ se@@ qu@@ enti@@ al . 	他 說 的話 根本 毫無 意義 。 
i 'm playing a tv game . 	我 在 玩 電視 遊樂器 。 
please sit down . 	請 坐下 。 
he lives by himself in the woods . 	他 獨自住 在 森林 裡 。 
my boss made me work overtime . 	我 的 老 闆 要 我 加班 。 
what does tom know about me ? 	湯姆 知道 我 的 什麼 ？ 
your brother got married , did n't he ? 	你 哥哥 結婚 了 ， 不是 嗎 ？ 
he was killed in a car accident . 	他 死 於 一場 車禍 。 
the lights are n't on . 	燈 沒有 亮 着 。 
what are you doing ? 	你 做 什麼 ？ 
how do i explain that to tom ? 	我 怎麼 跟 湯姆 解釋 ？ 
you 're going to wreck your eyesight if you play games all the time . 	要是 你老 打 遊戲 的話 ， 你 的 視力 會 下降 的 。 
languages are n't his for@@ te . 	語言 不是 他 的 強項 。 
tom was dressed like a pi@@ rate . 	Tom 穿 得 像 個 海盜 。 
this book is hard for me to read . 	這 本書 對 我 來說 很 難讀 。 
she is an ob@@ stin@@ ate girl . 	她 是 個 倔強 的 女孩 。 
i am at home . 	我 在家 。 
everyone wants what they ca n't have . 	每個 人 都 想要 得到 無法 擁有 的 東西 
can i talk to you priva@@ tely for a minute ? 	我能 跟 你 私下 談 一分鐘 嗎 ？ 
i laughed . 	我 笑 了 。 
please drive carefully . 	請 小心 駕駛 。 
i 'm tired of watching television . 	我 看 電視 看到 厭煩 了 。 
you should re@@ write this sentence . 	你 應該 重寫 這句 話 。 
tom did n't let his children go to mary 's party . 	湯姆 沒 有 讓 他 的 孩子 們 去 瑪莉 的 派 對 。 
tom did n't need to finish that work by today . 	湯姆 不必 今天 就 完成 那 工作 。 
how did your test go ? 	你 的 測驗 怎麼樣 ？ 
this is my wife . 	這 是 我 的 妻子 。 
he 's used to traveling . 	他 習慣 了 旅行 。 
tom is n't accustomed to walking bar@@ e@@ foo@@ ted . 	湯姆 不 習慣 光着 腳 漫步 。 
i am eating rice . 	我 在 吃 米飯 。 
do you plan to go abroad ? 	你 打算 出國 嗎 ？ 
you should go and brush your teeth . 	你 該 去 洗牙 了 。 
his respon@@ se was con@@ tr@@ ary to our expectations . 	他 的 迴應 出乎 我們 的 意料 。 
tom got first prize , did n't he ? 	湯姆得 了 第一名 ， 不是 嗎 ? 
tom 's french is already rather good . 	湯姆 的 發育 已經 很 好 了 。 
i ca n't follow his logic . 	我 無法 理解 他 的 邏輯 。 
the policeman a@@ imed his gun at the man . 	警察 瞄準 了 那個 男人 。 
tom ad@@ ded both his and mary 's name to the list . 	湯姆 將 他 自己 和 瑪麗 的 名字 添加 到 了 名單 上 。 
this makes me happy . 	這讓 我 開心 。 
are you ready ? 	你們 準備 好 了 嗎 ？ 
i do n't have the slightest intention of reti@@ ring . 	我 沒有 一點 退休 的 念頭 。 
is there anything you ca n't do ? 	有 你 不能 做 的 事 嗎 ？ 
that 's what i hope . 	我 希望 如此 。 
there is only one book on the desk . 	桌子 上 只有 一 本書 。 
that 's logi@@ cal . 	那 符合 邏輯 。 
do you want to hear it ? 	您 想 聽 它 嗎 ？ 
i 'm too drunk to do that . 	我 喝醉 了 ， 做 不到 。 
he has been secre@@ tly in love with her . 	他 一直 暗戀 着 她 。 
why should anyone be surprised ? 	爲什麼 任何人 應該 感到 驚喜 ？ 
she has to take a reme@@ di@@ al course in english . 	她 需要 上 英語 補習班 。 
the doctors are looking at an x-@@ ray . 	醫生 在 觀察 X 光片 。 
the man reading a paper over there is my uncle . 	在 那兒 看 報紙 的 男人 是 我 叔叔 。 
your behavior leaves much to be desi@@ red . 	你 的 行爲 離 要求 的 太遠 了 。 
he was able to solve the problem . 	他 能 解決 這個 問題 。 
careless@@ ness can lead to a serious accident . 	粗心大意 可能 導致 嚴重 的 事故 。 
what were you and tom doing yesterday ? 	你 和 湯姆 昨天 做 了 什麼 ？ 
he leaves for school at seven . 	他七點 鐘去 學校 。 
i have a lot of friends to help me . 	我 有 很多 朋友 幫 我 。 
i 'm going to see what i can do . 	我要 看看 我能 做 甚麼 。 
you can get from wa@@ sh@@ ing@@ ton to new york by train . 	你們 可以 乘 火車 從 華盛頓 去 紐約 。 
would you mind my opening the door ? 	你 介意 我 開門 嗎 ? 
i invited my friends to dinner . 	我 邀 請 我 的 朋友 吃 晚餐 。 
the police seem to know exactly where we are . 	警察 看來 很 清楚 我們 在 哪裡 。 
she kept the secret to herself . 	她 守 著 這個 祕密 。 
that was really un@@ fair . 	那真 不 公平 。 
they gave a big party for me . 	他們 為 我 辦 了 一個 盛大 的 派 對 。 
she bought two pairs of socks . 	她 買 了 兩雙 襪子 。 
it ca n't be ! 	這 不 可能 ！ 
he is good at ru@@ g@@ by . 	他 很 擅長 橄欖球 。 
i ca n't let you give me your last ten dollars . 	我 不能 讓 你給 我 你 最後十美圓 。 
`` shall i have him call you when he gets back ? '' `` yes , please . '' 	“ 等 他 回來 ， 我要 讓 他 給 你 打電話 嗎 ？ ” “ 是 的 ， 謝謝 。 ” 
i always enjoy listening to classical music in my free time . 	有空 的 時候 ， 我 總 喜歡 聽 古典 音樂 。 
how can i get to the police station ? 	我 怎麼 去 警察局 ？ 
my uncle lives in an apartment . 	我 叔叔 住 在 公寓 裡 。 
i 'm very sorry i came home so late . 	我 很 抱歉 那麼 晚 回家 。 
i dislike big cities . 	我 不 喜歡 大城市 。 
he majored in drama at college . 	他 在 大學 主修 戲劇 。 
what 's your name ? 	你 叫 什麼 名字 ？ 
no , i did n't write it . 	不 ， 我 沒 寫 。 
tom practiced in front of the mirror . 	湯姆 在 鏡 前練習 。 
i attempted to solve the problem . 	我試 圖解決 這個 問題 。 
would you please lend me some money ? 	你 能 借 我些 錢 嗎 ？ 
they have jobs . 	他們 有 工作 。 
he occasionally visited me . 	他 偶爾 會來 拜訪 我 。 
tell me your story . i am all ears . 	告訴 我 你 的 故事 。 我會 注意 聽 。 
you did n't tell me you worked for tom . 	你 沒 告訴 我 你 為 湯姆 工作 。 
we may need some . 	我們 可能 需要 一些 。 
look at that house . 	看 那個 房子 。 
i 'll have to think about it . 	我 將 考慮 考慮 。 
she prefers beer to wine . 	她 喜歡 啤酒 勝過 葡萄酒 。 
she has a little bread . 	她 有點兒 麪包 。 
i attended the meeting yesterday . 	昨天 我 出席 了 會議 。 
i have so many clothes i do n't know what to wear tomorrow . 	我 有 那麼 多 衣服 ， 以至於 我 不 知道 明天 穿 什麼 了 。 
as long as you keep quiet , you can stay here . 	只要 你 保持 安靜 , 你 可以 留在 這裡 。 
we watched them play baseball . 	我們 看著 他們 打 棒球 。 
do n't leave ! 	別 走 ！ 
i have to go to the bank . 	我 必須 到 銀行 去 。 
i am proud of my father . 	我 爲 我 父親 而 自豪 。 
she named all the flowers in the garden . 	她 給 花園裏 的 花都 起 了 名字 。 
she gave me these old co@@ ins . 	她給 了 我 這些 舊 硬幣 。 
we felt the house shake a little . 	我們 感覺 到 房子 搖動 了 一下 。 
we saw the children enter the room . 	我們 看到 了 孩子 們 進入 這個 房間 。 
selling cars is my job . 	賣車 是 我 的 工作 。 
if we do n't keep walking we 'll be late . 	再 不 走 就 遲到 了 。 
it was beginning to snow . 	開始 下雪 了 。 
what do you two do for fun ? 	你們 兩個 做 了 什麼 有趣 的 事情 呢 ？ 
she began to sing . 	她 開始 唱歌 了 。 
i saw tom almost every day last week . 	我 上週 幾乎 天天 見 到 湯姆 。 
you sing like an an@@ ge@@ l . 	你 唱歌 像 天使 。 
he studied hard . 	他 努力 學習 。 
this is my sister . 	這 是 我 的 妹妹 。 
he loves traveling . 	他 愛 旅行 。 
tom went back to his bedroom . 	湯姆 回到 了 他 的 臥室 。 
he is angry with you . 	他 在 生 你 的 氣 。 
stop reading . 	別 再念 了 。 
you do n't have to talk so loud . 	你 不必 這麼 大聲 說 話 。 
i do n't go to school on sundays . 	我 週日 不去 學校 。 
to my knowledge , she has n't married yet . 	據 我 所知 ， 她 還沒 結婚 。 
he told me that whatever might happen , he was prepared for it . 	他 告訴 我 不論 發生 什麼 ， 他 都 準備 好 了 。 
do n't leave me here alone . 	別 把 我 一個 人 留在 這裡 。 
he went by bicycle . 	他 騎 自行車 去 的 。 
i 'd like to go with tom . 	我 想 跟 湯姆 走 。 
nobody believes what i say . 	沒有 人 相信 我 說 的話 。 
hold fire . 	停火 。 
leave my car alone . 	離 我 的 車遠 一點 。 
they ste@@ pped a few pac@@ es forward . 	他們 前進 了 幾步 。 
what nonsense are you talking now ? 	你 胡說 什麼 呢 ？ 
i 'll see you a week from today . 	我 下星期 的 今天 會 和 你 見面 。 
he tends to be late for meetings . 	他 開會 往往 會遲 到 。 
what vegetables do you like to eat ? 	你 喜歡 吃 什麼 菜 ？ 
do you want rice ? 	你們 要 米 飯 嗎 ？ 
she 's already sleeping . 	她 已經 睡下 了 。 
you 'd better not wait here . 	你 最好 不要 在 這裡 等 。 
leave this to me . 	把 這個 留給 我 吧 。 
i 'm bored . 	我覺 得 很 無聊 。 
i do n't know if i can do it . 	我 不 知道 我能 不能 做 。 
a boy of seventeen is often as tall as his father . 	十七 歲 的 男孩 常常 長 得 和 他 父親 一樣 高 。 
let 's drink coffee while we talk . 	讓 我們 邊 喝 咖啡 邊談 。 
do you have any money with you ? 	你 身上 有 錢 嗎 ？ 
i 'll be seventeen next year . 	我 明年 17 歲 。 
`` is he going to swim tomorrow ? '' `` yes , he is . '' 	" 他 明天 會 去 游泳 嗎 ? " " 是 的 , 他會 。 " 
we 're special . 	我們 是 特別 的 。 
are n't you happy ? 	你 不快 樂 嗎 ? 
i sometimes break the rules . 	我 有時候 打破 規矩 。 
she took care of my dog . 	她 照顧 了 我 的 狗 。 
pick up the pencil from the floor . 	從 地上 撿 起 這支 鉛筆 。 
soldiers must carry out their orders . 	軍人 必須 履行 他們 的 命令 。 
am i allowed to use this ? 	能 讓 我 用 這個 嗎 ？ 
i ca n't put up with his ar@@ rog@@ ance . 	我 不能 忍受 他 的 傲慢 。 
please show me around . 	請 帶 我 到 處 看看 。 
watch out ! there 's a big hole there . 	小心 ！ 在 那裡 有 一個 大洞 。 
children do n't like to go out in the dark . 	孩子 們 不 喜歡 摸黑 外出 。 
is your family doing well ? 	你 的 家人 好 麼 ？ 
she has a gift for pro@@ phe@@ cy . 	她 有 預言 的 能力 。 
what tom really wanted was enough money to buy mary some flowers . 	湯姆 真正 想要 的 是 有 足夠 的 錢 給 瑪麗 買 一些 花 。 
breakfast is from seven to nine . 	早餐 時間 在 七點 到 九點 。 
i 'd rather be with you . 	我 更 願意 跟着 你 。 
what are you writing ? 	你 在 寫 什麼 ？ 
do n't put anything on top of the box . 	盒子 上面 不要 放 任何 東西 。 
tom has lost his interest in studying french . 	湯姆 已經 對學 法語 不 感興趣 了 。 
there were several rooms still vac@@ ant . 	還有 幾間 空房 。 
she kissed him on the cheek . 	她 在 他 的 臉頰 上 吻 了 一下 。 
there are many fish in this lake . 	這 湖裏 有 許多 魚 。 
i work with her boyfriend . 	我 和 她 的 男朋友 在 一起 上班 。 
she married a rich man . 	她 嫁 給 了 一個 有錢人 。 
they were worried . 	他們 擔心 。 
i do n't care . 	我 無所謂 。 
if you bite me , i 'll bite back . 	如果 你 咬 我 ， 我 就 咬 回來 。 
you do n't have to take an examination . 	你 不 需要 考試 。 
my attitude towards him changed . 	我 對 他 的 態度 變 了 。 
spanish is spoken in twenty countries . 	有 二十 個國家 說 西班牙 語 。 
she was in a hurry . 	她 在 趕時間 。 
he often sits for many hours reading books . 	他 常常 坐 着 看書 一連 好幾個 小時 。 
i resign . 	我 放棄 。 
do n't leave the tv on . 	不要 讓 電視機 開着 。 
who were you talking to ? 	你 和 誰 說話 呢 ？ 
i had a tennis match with him . 	我 曾 與 他 的 比賽 網球 。 
i think i 'll be able to deal with that . 	我 認爲 我能 做好 。 
cities are exciting places , but also stre@@ ssful . 	城市 是 令人 興奮 的 地方 ， 但 也 會 讓 人產生 壓力 。 
many people only speaks one language . 	許多人 只 說 一種 語言 。 
who wants hot chocolate ? 	誰 要 熱 巧克力 ？ 
which book is better ? 	哪 一本 書比 較 好 ？ 
who is your english teacher ? 	你 的 英語 老師 是 誰 ？ 
good night . 	晚安 。 
could you sign here ? 	你 能 在 這裏 簽名 嗎 ? 
the warnings were ignored . 	警告 被 忽視 。 
what do you do here ? 	你 在 這裡 做 甚麼 ？ 
why did you come here so early ? 	你 為 什麼 這麼 早來 這裡 ？ 
i found the boy fast asleep . 	我 發覺 男孩兒 酣然 入睡 了 。 
can you come for dinner tonight ? 	你 今天 晚上 能來 吃 飯 嗎 ？ 
do you have a red pencil ? 	你 有 紅色 的 鉛筆 嗎 ？ 
he does n't know how to swim . 	他 不會 游泳 。 
what 's the point in doing that ? 	那樣 做 有 什麼 用 ? 
turn left at the next corner . 	下 一個 街角 左轉 。 
do n't worry about such a thing . 	不要 擔心 這樣 的 事情 。 
i can make that happen . 	我 不能 讓 那事 發生 。 
we enjoyed ourselves at the party . 	我們 在 派 對 上 玩 得 很 開心 。 
we have to stop the ble@@ eding . 	我們 必須 止血 。 
beauty is but skin deep . 	美貌 只是 表面 性 的 東西 。 
my father can not lift it up . 	我父 親無法 擡起 它 。 
two months have passed since he left for france . 	自從 他 離開 去 法國 ， 已經 有 兩個 月 了 。 
i ca n't put up with it . 	我 無法 忍受 它 了 。 
when did you last see tom ? 	你 最後 一次 看到 湯姆 是 什麼 時候 ？ 
i have no objection to paying a special fee if it is necessary . 	如果 必要 的話 ， 我 不 反 對付 特別 費用 。 
spring is just around the corner . 	春天 快來 了 。 
tom is a c@@ lever kid . 	湯姆 是 聰明 的 孩子 。 
i could answer all the questions . 	我 可以 回答 所有 問題 。 
fire is always dangerous . 	火是 非常 危險 的 。 
i 'm completely exhausted . 	我 完全 地筋 疲力 盡 了 。 
may i see your passport ? 	我 可以 看看 你 的 護照 嗎 ？ 
we are encouraged to use our imagination . 	我們 被 鼓勵 使用 想像力 。 
i@@ cel@@ and used to belong to den@@ mark . 	冰島 以前 屬於丹麥 。 
would you carry my luggage upstairs ? 	你 可以 把 我 的 行李 拿到 樓上 嗎 ? 
he is one of my neighbors . 	他 是 我 的 一個 鄰居 。 
everyone admi@@ res the pictures painted by him . 	每個 人 都 很 欣賞 他 所畫 的 圖畫 。 
in japan , the new school year begins in april . 	日本 的 新學年 在 四月 開始 。 
a few years ago , our room had little furniture in it . 	幾 年前 ， 我們 的 房間裡 沒有 什麼 傢俱 。 
mary bought a skirt and a bl@@ ouse . 	瑪麗 買 了 一件 襯衫 和 一條 連衣裙 。 
i do my homework after school . 	我 在 放學 後 做作 業 。 
would three o'clock be all right ? 	三點鐘 可以 嗎 ？ 
a new team was for@@ med in order to take part in the boat race . 	爲了 參加 划船 比賽 ， 一支 新 的 隊伍 組成 了 。 
pa@@ ce yourself . 	量力而行 。 
harvard was founded in 16@@ 3@@ 6 . 	哈佛 始建 於 1636 年 。 
i do n't know anything about their relationship . 	我 對 他們 的關 係 一 無 所知 。 
tom was afraid to ask for help . 	湯姆 不敢 求助 。 
it 's my job . 	這是 我份 內 的 事 。 
waiter , please bring me some water . 	服務生 ， 請給 我 一些 水 。 
what 'll you be doing over the weekend ? 	你 整個 週末會 做 什麼 ？ 
she as@@ signed the work to him . 	她 把 這個 工作 派給 他 做 。 
his plan is dangerous ! 	他 的 計劃 是 危險 的 ！ 
tom , i want to have a chat with you . 	Tom ， 我 想 和 你 談談 。 
i found the co@@ mic book very interesting . 	我 發現 這本 漫畫 書 非常 有趣 。 
somebody 's got to do something . 	得 有人 做點 什麼 。 
are you meeting someone here ? 	你 在 這裏 是 要 見 誰 吧 ？ 
please take your shoes off . 	請脫 掉 你 的 鞋子 。 
boston is a wonderful city . 	波士頓 是 一座 非常 好 的 城市 。 
i 'm from singapore . 	我 是從 新加坡 來 的 。 
i think we should n't let tom do that again . 	我 認為 我們 不該 讓 湯姆 再 那麼 做 。 
they arrived late because of the storm . 	因爲 風暴 ， 他們 晚到 了 。 
he wo n't live a long life . 	他 不會長 壽 。 
why do n't you give it another try ? 	你 為 什麼 不再 試 一次 ? 
you wo n't be happy no matter what i do . 	無論 我 做 什麼 ， 你 都 不 高興 。 
we should call the doctor . 	我們 應該 去 請 醫生 。 
stop re@@ sist@@ ing ! 	停止 抵抗 ！ 
my fingers are so numb with cold that i ca n't play the piano . 	我 的 手指 凍僵 了 ， 以至於 無法 彈 鋼琴 了 。 
tom complained that mary never helped him . 	湯姆 埋怨 瑪麗 從來不 幫 他 。 
all you can do is to wait . 	所有 你 能 做 的 就是 等待 。 
you have to hurry . 	您 要 趕快 些 。 
he has a good comm@@ and of english . 	他 有 很 好 的 英語 能力 。 
watch out ! 	當心 ！ 
just take my word for it . 	請 相信 我 的 話 。 
which club do you belong to ? 	你屬 於 哪個 社團 ? 
this is considered to be a matter of great import@@ ance . 	這 被 認爲 是 一件 大事 。 
tom wasted time . 	湯姆浪費 時間 。 
almost no one believes her . 	幾乎 沒人 相信 她 。 
walk ahead of me . 	在 我 前面 走 。 
i do n't want there to be any mis@@ understanding . 	我 不想 有 任何 誤會 。 
what do you think of japanese food ? 	你 覺得 日本 料理 怎麼樣 ？ 
the number of traffic acci@@ dents seems to be on the increase . 	交通事故 的 數量 似乎 在 增長 。 
the old man lived there by himself . 	這個 老人 獨自住 在 那裡 。 
good morning . 	早上 好 ！ 
someone stole my wallet on the train . 	有人 在 火車 上 偷 了 我 的 錢包 。 
you should take care of your sick mother . 	你 應該 照顧 你 生病 的 母親 。 
please stop that right now . 	請 即刻 停止 。 
that 's a huge cha@@ ll@@ en@@ ge . 	這是 一個 巨大 的 挑戰 。 
it has nothing to do with you . 	跟 你 沒 有關 係 。 
he might change his mind . 	他 可能 會 改變 心意 。 
there was a minute of silence and then everybody started s@@ crea@@ ming . 	有 一分鐘 的 沉默 ， 然後 每個 人 都 開始 尖叫 。 
shakespeare is the name of a writer . 	莎士 比亞 是 一位 作家 的 名字 。 
what have you come here for ? 	你 爲什麼 來 這兒 ？ 
when will we go ? 	我們 甚麼 時候 出發 ? 
but you 're not there . 	但 你 不 在 那裡 。 
tom knows me . 	Tom 認識 我 。 
we have to sing at an old fol@@ ks home today . 	我們 今天 得 去 養老院 唱歌 。 
i want something sweet . 	我要 一些 甜 的 東西 。 
i wonder if they 'll get divorced . 	我 不 知道 他們 是否 會離婚 。 
i want to go abroad next year . 	我 明年 想 去 國外 。 
i asked twenty friends to the party . 	我 請 了 二十 位 朋友 參加 派 對 。 
the baby is sleeping . 	寶寶 正在 睡覺 。 
i may have made a mistake . 	我 可能 搞錯 了 。 
he 's good at flying kites . 	他 擅長 放風箏 。 
she was a genius in mathematics . 	她 是 個 數學 天才 。 
they grow flowers in the garden . 	他們 在 花園 裡種 花 。 
a lot of students around the world are studying english . 	世界 上 許多學生 正在 學習 英語 。 
i 'll swim . 	我要 游泳 。 
do you think we 'll have good weather ? 	你 認爲 我們 會 遇到 好 天氣 嗎 ？ 
tom wanted to know if mary had a boyfriend . 	湯姆 想 知道 瑪麗 是否 有 男朋友 ？ 
classes begin next week . 	課程 下週 開始 。 
you should study harder . 	你 應該 更 努力 學習 。 
you 're too generous . 	你 太 大方 了 。 
he is getting along with his neighborhood . 	他 和 他 的 鄰居 相處 。 
you can drive a car , ca n't you ? 	你會 開車 ， 不是 嗎 ? 
you might have heard of it . 	你 可能 聽說 過 。 
please come back as soon as possible . 	請 儘快 回來 。 
he 's not here yet . 	他 還沒到 這裡 。 
tom made his ser@@ v@@ ants eat in the dark . 	湯姆 讓 他 的 僕人 們 在 黑暗 下 進餐 。 
the lake was frozen . 	湖凍 冰 了 。 
he became more ob@@ stin@@ ate as he grew older . 	他 年紀 越大變 得 越 頑固 。 
tom was a bit puzzled by mary 's answer . 	湯姆 被 瑪麗 的 回答 困惑 了 一下 。 
tom is n't a very nice guy . 	湯姆 不是 個 多 好 的 人 。 
i am going to watch tv this evening . 	今天 晚上 我 打算 看電視 。 
i do n't know the meaning of this word . 	我 不 知道 這個 詞 的 意思 。 
he got thro@@ wn out of the house . 	他 被 趕出 了 這棟 房子 。 
the little cab@@ in was bath@@ ed in moonlight . 	小 木屋 沐浴 在 月光 之中 。 
you made the mistake on purpose , did n't you ? 	你 故意 犯 這個 錯 , 是 嗎 ? 
you are not to leave this room . 	你 不 可以 離開 這個 房間 。 
do you have one ? 	你 有 嗎 ？ 
i 'll act as a gui@@ de for you . 	我 爲 你 充當 導遊 。 
you may choose any of them . 	你 可以 選擇 他們 之中 的 任何 一個 。 
the clo@@ wn made a funny face . 	小丑 做 了 個 鬼臉 。 
i expect your help . 	我 期待 你 的 幫助 。 
she looks very ele@@ g@@ ant . 	她 看上去 十分 優雅 。 
would you like to eat with us ? 	你 想 和 我們 一起 吃 嗎 ？ 
can we talk in private ? 	我們 能 私下 談談 嗎 ？ 
are you a high school student ? 	你 是 高中生 嗎 ? 
they ate sandwiches for lunch . 	他們 午飯 吃 了 三明治 。 
i like coffee better than tea . 	我 喜歡 咖啡 勝過 茶 。 
i do n't want to lose you again . 	我 不想 再 失去 你 。 
ari@@ th@@ me@@ tic deals with nu@@ mbers . 	算數 處理 數字 。 
i had a nightmare . 	我 做 噩夢 了 。 
tom has made up his mind to go to boston to study . 	湯姆 已經 下定 決心 要 去 波士頓 唸 書 。 
i think i 've found the answer . 	我 想 我 找到 答案 了 。 
we 'll stay quiet . 	我們 會 保持 安靜 。 
she was scared to cross the road . 	她 怕 過馬路 。 
you 're always busy . 	你 一直 忙 。 
do n't inter@@ rupt our conversation . 	不要 打斷 我們 的 談話 。 
you should make no@@ tes . 	你 應該 做 筆記 。 
you do n't have to go to school on sunday . 	你 沒 必要 週日 去 上學 。 
women t@@ end to live longer than men . 	女人 往往 比 男人 活得 更長 。 
she insisted that i should see the doctor . 	她 堅持 讓 我 去 看 醫生 。 
he meets his girlfriend on saturdays . 	他 每 週六 和 他 的 女朋友 見面 。 
which way should we go ? 	我們 應該 往 哪個 方向 走 ？ 
are you taking any medicine regularly ? 	你 經常 服用 任何 藥物 嗎 ？ 
she is a pretty girl . 	她 是 一個 漂亮 的 女孩 。 
she played the guitar and he sang . 	她彈 吉他 ， 他 唱歌 。 
keep an eye on the bags . 	把 包包 看好 。 
my older sister often drinks tea with milk . 	我 的 姐姐 經常 就 着 牛奶 喝茶 。 
i usually got to bed about eleven . 	我 通常 約 十一 點鐘 上牀 睡覺 。 
people can easily tell the difference between them . 	人們 可以 很 容易 地 看出 其中 的 差別 。 
are you lost ? 	你 迷路 了 嗎 ？ 
i play in a band . 	我 在 一個 樂團裡 演奏 。 
tom is out of his mind . 	湯姆 失去 理智 了 。 
no matter where you go , i 'll follow you . 	無論 你 去 哪裡 我 都 會 跟 著 你 。 
leave the book where it was . 	把 書 放在 原處 。 
what do you think he did ? 	你 覺得 他 這樣 做 怎麼樣 ？ 
you have lovely eyes , do n't you ? 	你 有 一雙 可愛的 眼睛 ， 不是 嗎 ? 
tom wants me to stay away from him . 	Tom 要 我 離 他 遠 一點 。 
how come you know so much about japanese history ? 	你 為 什麼 知道 這麼 多 的 日本 歷史 ? 
i 'm married . 	我 結婚 了 。 
they became friends in ele@@ men@@ tary school . 	他們 在 小學時 就是 朋友 了 。 
it was so cold yesterday that i stayed home . 	昨天 太冷 了 ， 我 只好 待 在 家裏 。 
this is a present for you . 	這是給 你 的 禮物 。 
i was embarrassed by what she said . 	她 說 的 話 讓 我 覺得 很 尷尬 。 
i admit that he is right . 	我 承認 他 是 對 的 。 
grab a hold of the rope . 	抓住 繩子 。 
please enjoy yourself at the dance . 	請 盡情 地 跳舞 。 
tom wants children , but mary does n't . 	湯姆 想要 孩子 ， 但 瑪麗 不想 。 
none of us thought he was to blame for the accident . 	我們 都 不 認為 他 是 事故 的 罪魁 禍首 。 
i hope that you will get well soon . 	我 希望 您 快 就 會 好 起來 。 
go get your hel@@ met . 	戴上 你 的 安全 帽 。 
do n't throw trash here . 	別 在 這兒 扔 垃圾 。 
put on your good shoes . 	穿 上 你 的 好 鞋 。 
what do you think i 've been doing ? 	你 覺得 我 之前 在 做 什麼 ？ 
i miss you so much . 	我 如此 想念 你 。 
to my surprise , the door was un@@ locked . 	令 我 驚訝 的 是 ， 門沒 上鎖 。 
this is a very tall tree . 	這 是 棵 很 高 的 樹 。 
put the book on the bo@@ t@@ tom shelf . 	把 這本書 放在 架子 的 底部 。 
i love nature . 	我 愛 大自然 。 
do not fear the unexpected , but be prepared for it . 	不要 害怕 意外 ， 但 要 有 準備 。 
he seems to be rich . 	他 看 起來 很 有 錢 。 
i arrived at school on time . 	我 按時 到 了 學校 。 
it is a pity that you can not come to the party . 	很 遺憾 您 不能 來 派對 。 
can you please close that window ? 	請 您 把 那 扇 窗戶 關起 來 好 嗎 ？ 
she gave away all her dresses . 	她 把 她 所有 的 洋裝 都 送 人 。 
i think tom might not want to do that . 	我 認爲 湯姆 可能 不想 那樣 做 。 
he 's a good guy . 	他 是 個 好人 。 
is breakfast inclu@@ ded ? 	包括 早飯 嗎 ？ 
my birthday fa@@ lls on sunday . 	我 的 生日 在 星期日 。 
how far is it from here ? 	離 這兒 有多遠 ？ 
both of them are in the room . 	他們 兩個 人 都 在 房間裡 。 
tom will never see you again . 	湯姆 以後 再也 不會 見 你 了 。 
i asked her to wait a moment . 	我 請 她 等 一會兒 。 
he pretended not to hear me . 	他 假裝 沒 有 聽 見 我 。 
we ca n't afford to make mistakes . 	我們 承擔 不了 犯錯 的 後 果 。 
tom likes chocolate cake a lot . 	湯姆 很 喜歡 巧克力 蛋糕 。 
could you lend me the book ? 	你 能 借 我 這 本書 嗎 ？ 
i 'll be staying here for another three days . 	我會 在 這兒 再待 上 三天 。 
compare your translation with his . 	比較 你 和 他 的 翻譯 。 
no one supp@@ or@@ ted his mo@@ tion . 	沒人 支持 他 的 動議 。 
stop me@@ dd@@ ling . 	別 再 插手 。 
i want to brush up my english . 	我要 溫習 一下 我 的 英文 。 
he slipped me a note . 	他 悄悄地 遞給 我 一張 紙條 。 
i did n't get along with her . 	我 沒 有 和 她 相處過 。 
he has to repair the clock . 	他 必須 修理 這個 時鐘 。 
i 've always tru@@ sted your jud@@ g@@ ment . 	我 一直 都 相信 你 的 判斷 。 
about how much will i have to pay for all the treat@@ ments ? 	所有 的 醫藥費 我 大概 要付 多少 ？ 
i can not follow your logic . 	我 跟不上 你 的 邏輯 。 
the revolution has brought about many changes . 	這場 革命 已經 帶來 了 很多 改變 。 
mathematics is my favorite subject . 	數學 是 我 最 喜歡 的 科目 。 
let 's discuss it . 	來 商量 吧 。 
the boy f@@ eared the dark . 	這個 男孩 害怕 黑夜 。 
he is allergic to house dust . 	他 對室 內灰塵 過敏 。 
turn on the radio , please . 	請 打開 收音機 。 
he went to boston by car . 	他 坐 汽車 到 波士頓 。 
i was out of town on vacation . 	我 出城 度假 了 。 
this place still looks the same as it did a long time ago . 	這裡 就 像 在 古時候 一樣 。 
i want him to play the guitar . 	我要 他彈 吉他 。 
i have a new car . 	我 有 輛 新車 。 
what did you buy ? 	你 買 了 什麼 ？ 
you know i have no choice , do n't you ? 	你 知道 我 沒法 選擇 ， 不是 麼 ？ 
this is not a sentence . 	這 不是 一個 句子 。 
japan depends on foreign countries for oil . 	日本 依賴 外國 的 石油 。 
he f@@ ought against ra@@ cial discrimin@@ ation . 	他 反 對 種族 歧視 。 
tom has just returned from the post office . 	湯姆剛 從 郵局 回來 。 
the situation is getting worse and worse day by day . 	情況 一天 比 一天 差 。 
tom , i want to talk to mary . 	湯姆 ， 我 想 跟 瑪麗 談話 。 
you must always tell the truth . 	你 必須 永遠 說 實話 。 
we need a hero . 	我們 需要 英雄 。 
my brother likes hor@@ ror movies . 	我 哥哥 喜歡 恐怖 電影 。 
i like swee@@ ts . 	我 喜歡 甜食 。 
we really enjoyed ourselves . 	我們 真的 玩得 很 開心 。 
how heavy is your suitcase ? 	您 的 行李箱 有 多重 ? 
we 'll deal with this problem in cha@@ pter 3 . 	我們 在 第三章 討論 這個 問題 。 
i 'm afraid i 've off@@ ended you . 	我怕 我 冒犯 了 你 。 
a lot of houses were washed away by the flood . 	許多 房屋 被 洪水 沖走 了 。 
tom is working the night shi@@ ft . 	湯姆上 夜班 。 
do you promise ? 	你 保證 嗎 ？ 
i still have n't found work . 	我 還沒有 找到 工作 。 
turn on the radio . 	打開 收音機 。 
i do n't go to school by bus . 	我 不 乘 公交 去 學校 。 
you know quite a lot about su@@ m@@ o . 	你 對 相 撲 知道 得 很多 。 
what 's your telephone number ? 	你 電話號碼 是 多少 ？ 
he always keeps his room clean . 	他 總 是 把 他 的 房間 保持 乾淨 。 
are you still collecting stamps ? 	你 還在 收集 郵票 嗎 ？ 
his pictures were hung on the wall . 	他 的 畫 被 懸掛 在 牆上 。 
he will regret it sooner or later . 	他 遲 早會後悔 。 
you should begin with easier questions . 	你 應該 先 從 最 簡單 的 問題 開始 。 
i was born in the winter . 	我 在 冬天 出生 。 
if you need a dictionary , i can lend you my old one . 	如果 你 需要 字典 ， 我 就 把 我 舊 的 借給 你 。 
can i try on this jacket ? 	我 可以 試穿 這件 外套 嗎 ？ 
i had a neighbor who was blind . 	我 有 個 盲鄰 居 。 
green suits you . 	綠色 適合 你 。 
i put some cream in my coffee . 	我 在 我 的 咖啡 裡放 了 一些 奶油 。 
tom does n't understand this . 	湯姆 不 明白 這事 。 
where 's the nearest shopping ma@@ ll ? 	最近 的 大 賣場 在 哪裏 ？ 
tom is shy . 	湯姆 害羞 。 
this is the house where she used to live . 	這 是 她 曾經 住 過 的 房子 。 
i think tom 's ch@@ eating . 	我 覺得 湯姆 有 外遇 。 
this could be fun . 	這 可能 很 好玩 。 
could you lend me your bicycle for a couple of days ? 	你 能 把 你 的 自行車 借 我 兩天 嗎 ？ 
i do n't understand at all . 	我 完全 不 懂 。 
she may come . 	她 可以 來 。 
do you know how to dance ? 	你 會 跳舞 嗎 ？ 
would you like to wait ? 	你 願意 等 嗎 ? 
it 's pretty heavy . 	它 真重 。 
do you have a camera ? 	你 有 照相機 嗎 ？ 
the plane crash was only last week . 	上個 星期 這架 飛機 墜毀 了 。 
i 'll pick you up at your home . 	我會 去 你家 接 你 。 
your bicycle is similar to mine . 	你 的 腳踏車 和 我 的 很 相似 。 
i called him up yesterday . 	我 昨天 打電話給 他 。 
she kept on working . 	她 繼續 工作 。 
wash your feet . 	洗 您 的 腳 。 
he may have been ill . 	他 可能 病 了 。 
i do n't want to go there again . 	我 不想 再次 去 那兒 。 
i ran as fast as possible . 	我 盡 可能 地 跑 快 一點 。 
facts are stu@@ b@@ born things , but sta@@ ti@@ stics are p@@ liable . 	事實 是 倔強 的 ， 但 統計 是 柔順 的 。 
you and i are good friends . 	你 和 我 是 好 朋友 。 
you ask too many questions . 	你 問題 太多 了 
she gets up at seven . 	她 早上 7 點 起牀 。 
there was hardly anyone in the room . 	房間裡 幾乎 沒 有人 。 
tom wondered where mary had learned french . 	湯姆 想 知道 瑪麗 在 哪裏 學會 了 法語 。 
i do n't have a computer . 	我 沒 有 電腦 。 
tom ate half the cake by himself . 	湯姆 獨自 吃 了 半個 蛋糕 。 
he walks his dog every morning . 	他 每天 早晨 溜 狗 。 
let me make you some tea . 	讓 我給 你 沏茶 。 
i like tennis and golf . 	我 喜歡 打 網球 和 高爾夫球 。 
she 's about the same age as i am . 	她 大約 跟 我 同年 紀 。 
i ca n't b@@ end my right arm . 	我無法 彎曲 我 的 右 手臂 。 
there is a strike . 	有 罷工 。 
you need not do it at once . 	你 沒 必要 馬上 去 做 。 
she lived a lonely life . 	她 的 生活 很 寂寞 。 
he looked over my report . 	他 仔細 看 了 我 的 報告 。 
i ate bread and butter this morning . 	今天 早上 ， 我 吃 了 麪包 夾 黃油 。 
i was sho@@ cked by yesterday 's news . 	昨天 的 消息 讓 我 感到 震驚 。 
tom did n't attend the meeting . 	湯姆 沒有 參加 會議 。 
we expect a lot from him . 	我們 對 他 期望 很多 。 
she had already gone when i arrived . 	當我到 的 時候 ， 她 已經 走 了 。 
he is still here . 	他 還 在 這兒 。 
i love parties . 	我愛派 對 。 
`` where were you ? '' `` i was at a friend 's house . '' 	“ 你 在 哪裏 ？ ” “ 我 在 一個 朋友家 。 ” 
are you lost ? 	您 迷路 了 嗎 ？ 
come along with me . 	請 跟 我 來 。 
i can open the window . 	我 可以 打開 這扇 窗 。 
she is more pretty than beautiful . 	說 她 美 不如 說 她 可 愛 。 
do you have a lot of time to relax ? 	你 有 很多 休閒 時間 嗎 ？ 
she hit him . 	她 打 了 他 。 
many tv programs have a bad influence on children . 	許多 電視 節目 對 兒童 有 不良 的 影響 。 
it 's no good trying to persu@@ a@@ de her . 	試圖 勸 她 是 沒 有用 的 。 
tom is good at cooking . 	湯姆 擅長 烹飪 。 
i do n't think tom understands that . 	我 不 認為 湯姆 明白 。 
new year 's day is close at hand . 	元旦 就 在 眼前 。 
you are your own worst enemy . 	你 是 你 自己 最大 的 敵人 。 
he is difficult to get along with . 	他 這個 人 很 難 相處 。 
i do n't mind walking in the rain . 	我 不 介意 在 雨 中 漫步 。 
the baby cried all night . 	這 孩子 哭 了 一 整夜 。 
i expected him to offer some help . 	我 期待 他 提供 一些 幫助 。 
tom promised that he 'd come , but he did n't . 	湯姆答 應 他 會 來 ， 但 他 沒來 。 
tom refused to answer any questions . 	湯姆 拒絕 回答 任何 問題 。 
we got there at the same time . 	我們 在 同一 時間 到 了 那裡 。 
i do n't like sushi . 	我 不 喜歡 壽司 。 
she took full advantage of her stay in london to improve her english . 	她 充分 利用 她 住 在 倫敦 的 優勢 ， 提高 英語 。 
watch out for thi@@ e@@ ves around here . 	在 這 附近 當心 小偷 。 
my shoes are bigger than yours . 	我 的 鞋 比 你 的 大 。 
my father is swee@@ ping the garage . 	我 父親 正在 清掃 車庫 。 
refu@@ ge@@ es poured in from all over the country . 	難民 從 整個 國家 涌來 。 
the fox and the bear lived together . 	這 隻 狐狸 和 這 隻 熊 一起 生活 了 。 
let them take care of themselves . 	讓 他們 照顧 自己 。 
i 'm sorry , could you say that again ? 	抱歉 ， 你 能 再說 一遍 嗎 ？ 
he is as tall as his father . 	他 和 他 爸爸 一樣 高 。 
this is a comfortable chair . 	這 是 張 舒服 的 椅子 。 
put your hands up ! 	把手 舉 起來 ！ 
my sleep was distur@@ bed by the sound . 	那 聲音 攪 了 我 的 美夢 。 
the girl was afraid to jump down from the roof . 	小女孩 害怕 從 屋頂 上 跳 下來 。 
would you let me know when tom comes ? 	你 能 讓 我 知道 湯姆 什麼 時候 來 嗎 ？ 
i do n't like tea . 	我 不 喜歡 喝茶 。 
she made tea for me . 	她 給 我 沏 了 茶 。 
he lost his eyesight in an accident . 	他 在 一次 意外 中 失去 了 他 的 視力 。 
remember to mail this letter tomorrow morning . 	明天 早上 記得 去 寄 這 封信 。 
tom is a violin teacher . 	湯姆 是 小提琴 教師 。 
you should get your hair cut . 	你 該 理髮 了 。 
where is your dog ? 	你 的 狗 在 哪兒 ？ 
what shall we eat for breakfast ? 	我們 早飯 吃 什麼 ？ 
i like to travel by train . 	我 喜歡 搭 火車 旅行 。 
she got a new cd player yesterday . 	她 昨天 得到 了 一個 新 的 CD 播放 機 。 
i 'll drop by the post office on the way home . 	我會 在 回家 的 路上 順便 去 郵局 。 
tom certainly is an interesting person . 	湯姆 這人 確實 很 有意思 。 
i 'm closing the door . 	我 在 關門 。 
i talked with tom . 	我 和 湯姆 說 了 話 。 
are you busy now ? 	現在 你 們 忙 嗎 ？ 
i 'm bad at sports . 	我 不 擅長 運動 。 
i could n't remember their names . 	我 不 記得 他們 的 名字 了 。 
very few people live to be 100 . 	很少 人活 到 100 歲 。 
she walks . 	她 在 行走 。 
i do n't think tom understands what 's going on . 	我 不 認為 湯姆 知道 正在 發生 甚麼 。 
i arrived at the station on time . 	我準 時 到 達 了 車站 。 
he is very sensitive . 	他 很 敏感 。 
tom and mary both know who you are . 	湯姆 和 瑪麗 都 知道 你 是 誰 。 
december has thir@@ ty-one days . 	十二月 有 三十 一天 。 
it is difficult to understand his theory . 	他 的 理論 很 難懂 。 
it seems obvious that he is sick . 	似乎 很明顯 他 病 了 。 
you have a wonderful voice . 	你 有 副 好 嗓音 。 
when did you start working here ? 	從 什麼 時候 開始 您 就 這裏 工作 着 的 呢 ？ 
i could smell the alcohol on his breath . 	我能 聞到 他 呼吸 中 的 酒精 味 。 
i have n't seen you in ages . 	我 已經 好久 沒有 見 到 你 了 。 
this story is true . 	這個 故事 是 真的 。 
he sat on the bench . 	他 坐在 長 凳 上 。 
in the summer i wear shor@@ t-@@ slee@@ ved shir@@ ts . 	夏天 我 穿 短袖 襯衫 。 
let us know when you 'll arrive . 	讓 我們 知道 你 什麼 時候 會 到 。 
i could n't understand his ideas . 	我無法 理解 他 的 想法 。 
she kept me waiting for 30 minutes . 	她 讓 我 等 了 30 分鐘 。 
he pa@@ used to have a cigarette . 	他 停 下來 抽根菸 。 
he 's been to the stadium . 	他 去 過體育館 。 
please go to the bank . 	請 去 銀行 。 
i ca n't believe your parents let you come here by yourself . 	我 不敢 相信 你 父母 讓 你 自己 過來 。 
one of the children left the door open . 	其中 一個 孩子 讓門 開著 。 
i do n't know if tom can help us . 	我 不 知道 湯姆能 不能 幚 我 們 。 
a bookstore in that location would n't make enough money to survive . 	那個 地點 的 書店 無法 賺 足夠 的 錢 生存 下去 。 
nobody knows why he turns down my help . 	沒 有人 知道 他 為何 拒絕 我 幫忙 。 
he told me that he was busy then . 	他 告訴 我 他 那時 很忙 。 
this desk is de@@ signed for children . 	這張 書桌 是 專門 為 兒童 設計 的 。 
can you tell me how to get to the train station ? 	你 可以 告訴 我 如何 到 火車 站 嗎 ? 
this room is cleaned by tom . 	這房間 是 由 湯姆清 掃 的 。 
do you know the boy in the picture ? 	你 認識 畫 裏面 的 男孩 嗎 ？ 
she devoted her life to working among the poor . 	她 一生 致力 於 爲 窮人 工作 。 
you can lie to everyone else , but you ca n't lie to yourself . 	你 可以 向 別人 撒謊 ， 但 你 不會 向 自己 撒謊 。 
london is famous for its fog . 	倫敦 以霧 著名 。 
do n't talk in the classroom . 	別 在 教室 裡說 話 。 
why are you asking me ? 	你 為 什麼問 我 ？ 
he 's very fond of science fiction . 	他 非常 喜歡 科幻 小說 。 
he came back last au@@ gust . 	他 去年 八月 回來 的 。 
maybe they have something . 	他們 可能 有點 什麼 。 
i really do n't know that woman . 	我 完全 不 認識 那個 女人 。 
it 's not mine . 	不是 我 的 。 
let us know whether you can come . 	讓 我們 知道 你 是否 能來 。 
i 've had just about enough of her . 	我 真的 受夠 了 她 。 
how do you get your children to eat vegetables ? 	你 怎樣 讓 你 的 孩子 們 吃 蔬菜 ？ 
his ob@@ serva@@ tions are sharp , but he does n't say much . 	他 的 觀察是 敏銳 的 ， 但 他 沒 有 說 太 多 。 
not a single person arrived late . 	沒有 一個 人 遲到 。 
he usually goes to school by bus . 	他 經常 搭公車 上學 。 
we had a hear@@ t-@@ to@@ -@@ heart talk with each other . 	我們 促膝談心 。 
why do you ask ? 	你問 這個 幹什麼 ? 
it is true that she is pretty , but she is sel@@ fish . 	她 確實 很 漂亮 ， 但 她 很 自私 。 
the police are after him . 	警察 在 跟 著 他 。 
what do you think about this plan ? 	你 覺得 這個 計劃 怎麼樣 ？ 
she seemed to have been ill . 	好像 她 病 了 。 
i was almost hit by a car . 	我 幾乎 被 車撞 到 了 。 
you can dele@@ te that now . 	你 現在 可以 刪除 它 。 
if you eat that much , you 'll have a stomachache . 	那麼 吃 的話 ， 肚子 會 吃 壞 的 噢 。 
is there a service charge for that ? 	要 收服 務費 嗎 ? 
i hope that mary pas@@ ses the examination . 	我 希望 瑪麗 通過 考試 。 
he did n't know that . 	他 不 知道 。 
my father has been engaged in foreign tra@@ de for many years . 	我 父親 經營 外貿 多年 。 
the boy is playing with his toy soldiers . 	男孩 在 玩 玩具 兵 。 
my father is suffering from a cold . 	我 父親 感冒 了 。 
he knows how to swim . 	他會 游泳 。 
i 'm going to go tell tom . 	我要 告訴 湯姆 。 
look at that smoke . 	快 看 那個 煙 。 
i had a telephone call from her . 	她 打 了 一通 電話給 我 。 
i en@@ coun@@ ter@@ ed a problem . 	我 遇到 了 故障 。 
he comes here almost every day . 	他 幾乎 每天 都 來 。 
she got wet to the skin . 	她 渾身 濕透 了 。 
he 'll be back home soon . 	他 很快 就 會 回家 。 
this is a bird san@@ c@@ tu@@ ary . 	這是 鳥類 庇護 所 。 
tom is at school , is n't he ? 	湯姆 在 學校裡 ， 不是 麼 ？ 
she seems to hate you . 	她 好像 很 討厭 你 。 
may i ask you some more questions ? 	我 可以 問你 一些 問題 嗎 ？ 
let me buy you another one . 	我 給 你 再 買 一個 吧 。 
i 'd like to check out right now . 	我想現 在 結帳 離開 。 
is it poi@@ son@@ ous ? 	它 有毒 嗎 ？ 
he enjo@@ ys watching baseball games on tv . 	他 喜歡 看 電視 上 的 棒球 比賽 。 
your composition has a few mistakes . 	你 的 作文 有 一些 錯誤 。 
no students were absent . 	沒有 學生 缺席 。 
who told you that tom and i are dating ? 	誰 告訴 你 我 和 湯姆 在 交往 的 ？ 
i do n't like going to school . 	我 不 喜歡 上學 。 
this is surpri@@ sing . 	這是 令人 吃 驚 的 。 
it 's great . 	真是 太好 了 。 
things are totally different now . 	現在 全都 不一樣 了 。 
this letter is ad@@ dressed to you . 	這 封信 是 寄給 你 。 
this stone is too heavy to lift . 	這塊 石頭 太重 了 無法 擡起 來 。 
why do you want to be a nurse ? 	你 爲什麼 想 成爲 護士 呢 ？ 
you 've worked hard for months and have certainly earned a holiday . 	你 已經 辛苦 地 工作 好 幾個 月 了 , 當然 可以 休假 。 
more often than not , she had to go in person . 	很多 時候 她 要 親自去 。 
we talked over the plan with him . 	我們 和 他 談 了 這個 計劃 。 
tom is n't as innocent as he seems . 	湯姆 不像 他 看上去 的 那樣 無辜 。 
i knew you 'd find tom . 	我 知道 你 會 找到 湯姆 。 
is this the bus for park ri@@ dge ? 	這是 去 帕克 裏奇 的 巴士 ？ 
he is driving at top speed . 	他 全速 駕駛 着 。 
how about going to see a movie tonight ? 	今晚 看 電影 怎麼樣 ？ 
he 's eating an apple . 	他 正 吃 著 一個 蘋果 。 
he did n't hear his name called . 	他 沒 聽見 有人 叫 他 的 名字 。 
tom can swim almost as fast as i can . 	湯姆 幾乎 能遊 得 跟 我 一樣 快 。 
it 's hard to quit smoking . 	戒菸 難 。 
i feel like taking a bath now . 	我現 在 想 洗澡 。 
by the way , my english is absolutely hopeless . 	順道 一提 ， 我 的 英語 是 絕對 沒有 希望 了 。 
he thought of a good solution . 	他 想到 了 一個 解決 的 好 辦法 。 
this is the end . 	這是 結束 。 
tom is a very talented writer . 	湯姆 是 個 很 有 才華 的 作家 。 
let me ask a stupid question . 	我來 問個 有點 傻 的 問題 。 
keep oil away from the fire . 	讓 油遠 離火 。 
do you think you could make a little less noise ? 	你 覺得 你 能少 發點 噪音 嗎 ？ 
eighty percent of all information on computers around the world is in english . 	全世界 百分之八十 電腦 上 的 資訊 都 是 用 英語 寫 的 。 
here 's how we do it . 	以下 是 我們 怎麼 做 的 。 
app@@ ar@@ ently , there is nothing that can not happen today . 	顯然 ， 今天 什麼 事 都 有 可能 發生 。 
lincoln was elected president in 18@@ 6@@ 0 . 	林肯 在 1860 年 當選為 美國 總統 。 
i lost my camera the other day . 	那天 我 丟 了 我 的 照相機 。 
i could n't answer all the questions . 	我 無法 回答 所有 問題 。 
i like being on the team . 	我 喜歡 在 隊伍 裏 。 
he is afraid of his own sha@@ dow . 	他怕 自己 的 影子 。 
did you know that before ? 	你 之前 知道 那個 嗎 ？ 
i 'd like the sauce on the side . 	我 想要 醬料 放在 旁邊 。 
she wore a red dress . 	她 穿 了 一條 紅色 的 裙子 。 
mary closed the door quietly . 	瑪麗 悄悄地 關上 了門 。 
she is walking . 	她 在 行走 。 
i want to be as tall as tom . 	我 想 和 Tom 一樣 高 。 
he had his head in the clouds in class . 	他 在 課 堂上 心不在焉 。 
just relax . 	放鬆 點 吧 。 
what 's your opinion on that ? 	關於 那個 你 有 什麼 看法 ？ 
tom studies at harvard . 	湯姆 在 哈佛 學習 。 
i have to go to sleep . 	我 該 去 睡覺 了 。 
i am a japanese high school girl . 	我 是 一個 日本 的 高中 女生 。 
i ca n't get at the exact meaning of the sentence . 	我 抓 不到 句子 的 確切 含義 。 
i 'm sorry , but i really have to go . 	我 很 抱歉 ， 但 我 必須 走 了 。 
take it easy . 	別緊 張 。 
i 'm in@@ cre@@ di@@ bly tired . 	我 累死 了 。 
she 's very beautiful . 	她 非常 漂亮 。 
can i go swimming this afternoon ? 	我 今天 下午 可以 去 游泳 嗎 ？ 
actions speak louder than words . 	行動勝 於 雄辯 。 
he went to america to study medicine . 	他 去 美國 學醫 了 。 
do n't forget to lock up when you leave . 	當 你 出門 時 ， 別 忘 了 鎖門 。 
she was coming down the stairs . 	她 下樓 。 
you ca n't do two things at once . 	你 不能 一心 兩用 。 
she says he will not give up smoking . 	她 說 他 不會 戒煙 。 
i ca n't concentrate on my work because of the noise . 	由於 噪音 ， 我 無法 集中 精力 工作 了 。 
why do you want to kill me ? 	你們 為 什麼 想 殺 我 ？ 
it is easy to swim . 	游泳 很 簡單 。 
it must be done more carefully . 	應該 更 謹慎 地 處理 它 。 
i hope i will have a chance to see you next time i 'm in new york . 	希望 下次 我 在 紐約 還 可以 有 機會 見到 你 。 
tell tom i 'll be there in a minute . 	告訴 Tom 我 將 在 一分鐘 內 到達 這裏 。 
he came at three in the afternoon . 	他 在 下午 三點鐘 的 時候 來 了 。 
do you have it ? 	你們 有 嗎 ? 
he does not like being punished . 	他 不 喜歡 被 懲罰 。 
i 'm not sure tom would help . 	我 不 確定 湯姆能 不能 幫忙 。 
winter is just around the corner . 	冬季 快來 了 。 
someone is watching . 	有人 在 監視 。 
i have just finished my homework . 	我 剛剛 完成 我 的 作業 。 
liars must have a good memory . 	騙子 們 必須 有 好 記性 。 
please speak slowly . 	請 說 慢 一些 。 
she 's still dependent on her parents . 	她 現在 依然 依靠 父母 生活 。 
tom knows him . 	湯姆 認識 他 。 
she wants a new dress badly . 	她 很 想要 一條 新 的 連衣裙 。 
this is kind of interesting . 	這 真是 有趣 。 
his explanation is not clear . 	他 的 說 明並 不 清楚 。 
how can i reach you ? 	我 怎麼 聯繫 你 ？ 
i gave careful consideration to the problem . 	我 仔細地 考慮 了 這個 問題 。 
he studied abroad . 	他 出國 留學 了 。 
only ad@@ ults may watch that film . 	只有 成人 可以 看 那種 電影 。 
do we know you ? 	我們 認識 你 麼 ？ 
yes , of course . 	是 的 ， 當然 。 
you are wanted on the phone . 	有 你 的 電話 。 
call an ambu@@ lance . 	叫 救護車 。 
how was the food ? 	食物 怎麼樣 ？ 
that student runs fast , does n't he ? 	那個 學生 跑 得 很快 ， 不是 嗎 ？ 
he accepted my idea . 	他 接受 了 我 的 主意 。 
tom was hit by a truck and died in@@ stantly . 	湯姆 被 卡車 撞 到 而且 當場 死亡 。 
he gave the same answer as before . 	他給 了 跟 以前 一樣 的 回答 。 
the boy went to bed with his socks on . 	男孩 穿着 襪子 就 上牀 睡覺 了 。 
the two of us do n't belong here . 	我們 倆 不 屬於 這兒 。 
he att@@ ri@@ bu@@ tes his success to good luck . 	他 將 他 的 成功 歸功 於 好運 。 
take things a little more seriously . 	對 事情 比較 正經 嚴肅 。 
you 're im@@ patient . 	你 缺乏 耐心 。 
it ser@@ ves you right . 	自作自受 。 
have you eaten your lunch yet ? 	你 吃 過午 飯 了 嗎 ？ 
the letter was finished . 	信寫 完 了 。 
i 'm very worried about my weight . 	我 很 擔心 我 的 體重 。 
would you pass me the salt , please ? 	請 你 把 鹽 遞給 我 好 嗎 ? 
you 're very smart . 	你 很 聰明 。 
it is not always cold in hokkaido . 	北海道 並不總是 寒冷 。 
christmas is soon , right ? 	聖誕節 很快 就 到 了 ， 對 嗎 ？ 
i have only five thousand yen . 	我 只有 5000 日元 。 
put your hat on . 	戴上 你 的 帽子 。 
i have a bath every day . 	我 每天 洗 一次 澡 。 
my grandfather is fond of taking a walk early in the morning . 	我 的 爺爺 喜歡 大清早 的 散步 。 
bring the key . 	帶 鑰匙 來 。 
can you drive a manu@@ al tran@@ smi@@ ssion ? 	你會 開手 排車 嗎 ? 
in case of an emergency , get in touch with my ag@@ ent . 	萬一 有 緊急 情況 ， 聯繫 我 的 代理人 。 
it goes without saying that health is important . 	不用說 ， 健康 是 重要 的 。 
please do n't say that . 	請 你 不要 說 這個 。 
he was late because of the snow . 	他 因為 下雪 所以 遲到 了 。 
i do n't like eggs . 	我 不 喜歡 雞蛋 。 
i spent last sunday reading a novel . 	我 上 週日花 時間 看 了 一本 小說 。 
my son is engaged to his secretary . 	我 的 兒子 和 他 的 祕書訂 婚 了 。 
i 'll leave this work to you . 	我會 把 這個 工作 留給 你 。 
do you subscribe to any magazines ? 	你 有 訂閱 任何 雜誌 嗎 ？ 
can you play the piano ? 	你會彈 鋼琴 嗎 ？ 
how much is the commi@@ ssion ? 	手續費 是 多少 ？ 
do n't listen to her . 	別 聽 她 的 。 
what was that you just said ? 	你 剛 說 了 什麼 ？ 
it is easy to read this book . 	讀 這 本書 很 容易 。 
i ca n't stand this pain any more . 	我 不能 再 忍受 這種 痛苦 了 。 
tom had never lied to me before . 	湯姆 以前 從 不 向 我 說 謊 。 
i was very tired last night . 	我 昨晚 很累 了 。 
sir , can we quickly in@@ spect your luggage please ? 	先生 ， 我們 可以 檢查 一下 您 的 行李 嗎 ？ 
he may be able to come tomorrow . 	他 也許 明天 能來 。 
air is to us what water is to fish . 	空氣 對人 來說 就是 水對 魚 的 意義 。 
how did you get out of your room ? 	你 怎麼 從 你 的 房間 裏 出來 ？ 
she made a mess of the work . 	她 把 工作 弄 得 一團 糟 。 
the huge explosion killed six people . 	大 爆炸 致死 六人 。 
if you 're not listening to the radio , turn it off . 	要是 你 不 在 聽 廣播 的話 ， 就 關掉 它 。 
i do n't think he 'll say yes . 	我 不 認為 他 會 說 好 。 
time wai@@ ts for no one . 	時間 不 等 人 。 
he sha@@ ves every day . 	他 每天 刮 鬍 子 。 
we were n't able to find tom . 	我們 找 不到 湯姆 。 
the sky turned dark . 	天暗 了 下來 。 
we 're almost broke . 	我們 快 破產 了 。 
you did n't tell me mary was so beautiful . 	你 沒 告訴 我 瑪麗 這麼 漂亮 。 
that 's what tom promised . 	那 是 湯姆 承諾 的 。 
ladies and gentle@@ men , due to an accident at the airport , our arri@@ val will be delayed . 	女士 們 ， 先生 們 ， 由於 機場 的 意外 情況 ， 我們 的 着陸 將 被 推遲 。 
i want to go for a swim . 	我 想 去 游泳 。 
it is too late . 	太晚 了 。 
this is my business address . 	這 是 我 的 公司 地址 。 
our new home has an elevator . 	我們 的 新家 有 一 臺 電梯 。 
i should do it . 	我 應該 去 做 。 
we owe you an apology . 	我們 欠 你 個 道歉 。 
this is n't a good idea . 	這 不是 好 主意 。 
i want to get rid of it . 	我想 擺脫 它 。 
have fun . 	玩得 開心 。 
let 's take it easy . 	讓 我們 放 輕 鬆 吧 。 
my uncle never writes letters . 	我 的 叔叔 從來 不 寫 信 。 
he has been to hokkaido . 	他 曾 去過 北海道 。 
i ca n't go . 	我 不能 走 。 
he threw a stone at the big dog . 	他 朝着 大狗 扔 了 塊 石頭 。 
he was born on july 2@@ 8@@ th , 18@@ 88 . 	他 出生 於 1888 年 7 月 28 日 。 
i 'm stuck in my job . 	我 被 工作 困住 了 。 
he threw a rock into the pond . 	他 扔 一塊 石頭 到 池塘 裡 。 
some people like summer , and others like winter . 	有人 喜歡 夏天 ， 有人 喜歡 冬天 。 
she is always dressed in black . 	她 總 是 一身 黑 。 
did you find anything interesting ? 	你 找到 有趣 的 東西 了 嗎 ？ 
i asked him to wait here . 	我 請 他 在 這裡 等 。 
turn left at the first light . 	在 第一 個 紅綠燈 左轉 。 
i 'm young . 	我 還年 輕 。 
the lid wo n't open . 	這蓋子 打不開 。 
what 'll you be doing at this time tomorrow ? 	你 明天 這個 時候 會 是 在 做 什麼 ？ 
you should n't go out . 	你 不 應該 出去 。 
do you think animals have a soul ? 	你 認爲 動物 有 靈魂 嗎 ？ 
our child likes dogs , but i prefer cats . 	我們 的 孩子 喜歡 狗 ， 但 我 更 喜歡 貓 。 
i walked as far as the station . 	我們 走 到 跟 火車 站 那樣 遠 的 地方 。 
i know that you are busy . 	我 知道 您 們 也 很 忙碌 。 
my father has been to australia twice . 	我 父親 曾 經去過 澳洲 兩次 。 
i like to do my homework . 	我 喜歡 做 我 的 作業 。 
the room origin@@ ally had no furniture . 	本來 這間 房間 裏 沒有 傢俱 。 
i got on the wrong train . 	我 上 錯 了 火車 。 
brush your teeth before going to bed . 	上牀 睡覺 前要 刷牙 。 
there is a cat under the desk . 	書桌 下有 一隻 貓 。 
there are several ways to mea@@ sure speed . 	測速 的 方法 有 很多 。 
when was tom fired ? 	湯姆什麼 時候 被 開除 的 ? 
i could n't agree with you more . 	我 非常 同意 你 。 
we hope you will enjoy the show . 	我們 希望 你 喜歡 這個 表演 。 
that was the first time that a man walked on the moon . 	那 是 人類 第一次 在 月球 上 行走 。 
is one thousand yen enough ? 	1000 日元 夠 不夠 ？ 
i 've never seen him wearing jeans . 	我 從 來 沒 有 看過 他 穿 牛仔 褲 。 
i like these . 	我 喜歡 這些 。 
i was absent from the party . 	我 沒 去 派 對 。 
why do you need to read such a book ? 	爲什麼 你 要 讀 這樣 一 本書 ？ 
i have a certain amount of money on me . 	我 有些 錢 。 
his wife is in the hospital because she was injured in a car crash . 	他 的 妻子 在 醫院裡 因為 她 在 一場 車禍 中 受傷 了 。 
i am studying now . 	我 現在 正在 學習 。 
her father passed away last week . 	她 的 父親 上 週 去世 了 。 
school will start next monday . 	下週一 開學 。 
it makes no difference to me . 	這對 我 沒什麼 差別 。 
i think i may have made a big mistake . 	我 認為 我 可能 已經犯 了 大錯 。 
tom wanted to see mary 's room . 	湯姆想 看看 瑪麗 的 房間 。 
i 'm glad to hear that . 	我 很 高興 聽 到 這個 消息 。 
may i borrow your car ? 	我 可以 借用 你 的 車嗎 ？ 
there was a big earthquake last night . 	昨晚 有 一場 大 地震 。 
is it far ? 	遠 嗎 ？ 
tom thanked mary for coming . 	湯姆 感謝 瑪麗 的 光臨 。 
the experiment was successful . 	這實驗 是 成功 的 。 
even though she grew up in japan , she speaks fluent english . 	儘 管 她 在 日本 長 大 ， 她 說 一口 流利 的 英語 。 
are you afraid of bu@@ gs ? 	你 怕 蟲子 嗎 ？ 
what 're you after ? 	你 想要 什麼 ? 
may i see your driver 's license ? 	我 可以 看看 你 的 駕駛 執照 嗎 ？ 
he has n't come yet . 	他 還沒來 。 
this knife is very sharp . 	這 把 刀 很 鋒利 。 
tom says he 's very rich . 	湯姆 說 他 很 有 錢 。 
my father took out his wallet and gave me ten dollars . 	我 爸爸 拿出 他 的 錢包 ， 並 給 了 我 10 美元 。 
she st@@ ab@@ bed him in the back . 	她 在 他 的 背上 戳 了 一下 。 
none of these buses go to shinjuku . 	這些 巴士 中 沒 有 一輛 去 新宿 。 
please tell me when to go . 	請 告訴 我 什麼 時候 該 走 。 
we 'd better wake tom up . 	我們 最好 叫醒 湯姆 。 
those houses are 5@@ 00 years old . 	那些 房子 有 500 年 了 。 
i want an mp@@ 3 player ! 	我 想要 一個 MP3 播放器 ！ 
tom knows the difference . 	湯姆 知道 不同 之處 。 
the vacation is over now . 	現在 假期 結束 了 。 
i always study hard . 	我 總 是 用功 讀書 。 
i have to give back the book before saturday . 	我 必須 在 禮拜六 之前 把 書 還 回去 。 
i owe him 1@@ ,000 dollars . 	我 欠 他 1000 美元 。 
it 's already time to go home . 	已經 是 時候 回去 了 。 
he was mad because he was not invited . 	他 因爲 沒有 被 邀請 而氣 得 快 瘋 了 。 
i know you 're rich@@ er than me . 	我 知道 你 比 我 有 錢 。 
he made his son a weal@@ thy man . 	他 使 他 兒子 成 了 個 有錢人 。 
i heard our dog bar@@ king all night . 	我 聽 到 我們 的 狗 叫 了 一 整夜 。 
please give me something hot to drink . 	請給 我 一些 熱的 東西 喝 。 
tom said he keeps a gun in his home . 	湯姆 說 他 的 家裡 有 把 槍 。 
here , catch ! 	這裏 ， 快 抓住 。 
may i go out to play ? 	我 可以 出去 玩 嗎 ？ 
did you get the package i sent you ? 	你 收到 我寄給 你 的 包裹 了 嗎 ？ 
i 'd like to try this on . where are the fi@@ tting rooms ? 	我 想 試試 這件 。 請問 哪裏 是 試衣間 ？ 
i felt like crying . 	我 想 哭 。 
maybe you 'd better come with us . 	也許 你 最好 和 我們 一起 來 。 
let 's go ! 	走 吧 。 
tell me what to do with it . 	告訴 我 拿 它 做 什麼 。 
i helped her wash dishes . 	我 幫 她 洗碗 。 
do you have a tv ? 	你 有 電視 嗎 ？ 
you 're just a coward . 	你 就是 膽小鬼 。 
we want to be on the first bus tomorrow morning . 	我們 想 乘 明天 早上 第一 班 公交車 。 
i do n't feel comfortable here . 	我 在 這裡 感到 不 舒服 。 
i asked a policeman for directions . 	我 向 一個 警察 問路 。 
let 's go out and eat dinner together from time to time . 	讓 我們 偶爾 出去 一起 吃 晚餐 。 
he lost a fortune in the stock market . 	他 玩 股票 賠 了 。 
he is rather hard to please . 	取悅 他 很 難 。 
he lives alone . 	他 獨自 生活 。 
please allow me to go . 	請 允許 我 去 。 
i saw him wash the car . 	我 看 見 他 洗車 。 
that 's great . 	那 真是 太好 了 。 
he ca@@ tches colds easily . 	他 很 容易 感冒 。 
which of these ra@@ ckets is yours ? 	這些 球拍 中 哪 一支 是 你 的 ？ 
what 's tom so angry about ? 	湯姆為 了 甚麼 生氣 ？ 
i 'm your part@@ ner . 	我 是 你 的 夥伴 。 
you can tell us . 	你 能 告訴 我們 。 
i 'll see you whenever it suits you . 	只要 你 方便 ， 我什麼 時候 都 可以 跟 你 見面 。 
tom was wearing a bul@@ le@@ t@@ proof v@@ est , so the bul@@ let did n't kill him . 	湯姆 穿 著 一件 防彈 衣 ， 所以 子彈 沒 把 他 殺 死 。 
my sister and i went to the castle . 	我 和 妹妹 去 了 城堡 。 
you are not a doctor . 	您 不是 醫生 。 
could you please not smoke in this room ? 	請問 你 能 不 在 房間 裏 吸菸 嗎 ？ 
where do you attend high school ? 	你 在 哪裡 唸 高中 ? 
fire is always dangerous . 	火總是 危險 的 。 
i think we should try it . 	我 認為 我們 該 試試 。 
that red dress looks good on her . 	她 穿 那件 紅色 的 衣服 很 好看 。 
i 'm exhausted . 	困死 了 。 
tom is taller than i am . 	湯姆比 我 高 。 
he does n't have to go to school . 	他 不必 上學 。 
tell us more . 	告訴 我們 多 一點 。 
for the other 6@@ 00 million people , english is either a second language or a foreign language . 	對 於 其他 的 六 億 人口 而言 ， 英語 不是 第二 語言 就是 外語 。 
when i was a child , i used to swim in that pond . 	當 我 還是 個 孩子 的 時候 ， 我 在 這個 泳池 裏遊 過泳 。 
he showed me the manu@@ scri@@ pt of his new play . 	他 給 我 看 了 他 最新 劇 的 底稿 。 
i 'll never tell anyone where i 've hi@@ d@@ den the trea@@ sure . 	我 不會 告訴 任何人 我 藏寶 的 地方 。 
i know someone who might be able to help . 	我 知道 有個 人 可能 能 幫忙 。 
can she en@@ dur@@ e a long trip ? 	她 能 忍受 長 途 旅行 嗎 ？ 
this juice tastes sour . 	這個 果汁 喝起 來 酸酸的 。 
mary showed the letter to me . 	瑪麗給 我 看 了 這 封信 。 
i 'm almost finished reading this book . 	我 就要 讀完 這 本書 了 。 
are n't you tom ? 	你 不是 湯姆 嗎 ? 
she usually gets up early . 	她 通常 很早 起牀 。 
he kept his promise . 	他 信守 了 他 的 承諾 。 
could you teach me how to play the piano ? 	您 能教 我彈 鋼琴 嗎 ？ 
tom went into the kitchen and poured himself a cup of coffee . 	湯姆 進 了 廚房 ， 給 自己 倒 了 杯 咖啡 。 
he always tells the truth . 	他 總 是 說 實話 。 
i 'll tell tom you said that . 	我會 告訴 湯姆 你 說 了 那話 。 
tom showed up just in time . 	湯姆 剛好 準時 到 了 。 
let me think . 	讓 我 想 一想 。 
i have brothers . 	我 有 兄弟 。 
he is likely to win the game . 	他 有 可能 贏得 比賽 。 
close the door . 	關門 。 
do n't do anything like that again . 	不要 再 做 那樣 的 事情 了 。 
this is a good place to pi@@ tch a tent . 	這 是 搭 帳篷 的 好 地方 。 
what 's the weather like today ? 	今天 天氣 怎麼樣 ？ 
my friends invited me to dinner . 	我 的 朋友 邀請 我 去 吃 晚飯 。 
it 's not a cat . it 's a dog . 	它 不是 貓 。 它 是 狗 。 
she thought of a good solution . 	她 想到 了 一個 好 的 解決辦法 。 
could you come and see me tomorrow ? 	你 明天 可以 來 看 我 嗎 ？ 
he walked in the park yesterday . 	他 昨天 在 公園裡 散步 。 
can you skate ? 	你 會 溜冰 嗎 ？ 
i do n't fear death . 	我 不怕死 。 
there is an apple on the desk . 	書桌 上 有 一個 蘋果 。 
wonderful ! 	很棒 ！ 
tom heard this and got angry . 	聽到 這事 之 後 ， 湯姆為 之色變 。 
tom has n't talked to mary in years . 	湯姆 多年 沒有 和 瑪麗 說話 了 。 
i ca n't believe tom just did that . 	我 不敢 相信 湯姆 那麼 做 了 。 
she made cookies for the children . 	她 給 孩子 們 做 了 曲奇 。 
thank you for coming to meet me . 	謝謝 你 來 跟 我 見面 。 
children really like playing on the beach . 	孩子 們 非常 喜歡 在 海灘 上 玩耍 。 
he keeps his room clean . 	他 保持 他 的 房間 乾淨 。 
they say that old house is haunted . 	據 說 老房子 鬧 鬼 。 
the bar@@ o@@ me@@ ter is fa@@ lling . it is going to rain . 	氣壓計 下降 了 - 要 下雨 了 。 
you ca n't park around here . 	你 不能 在 這 附近 停車 。 
this time , it 's different . 	這次 不 一樣 。 
do not leave the lights on when you leave the room . 	離開 房間 時 ， 不要 留燈 。 
the moonlight is really beautiful . 	月光 真美 。 
where are my books ? 	我 的 書 在 哪 ？ 
he is not from hokkaido . 	他 不是 來 自 北海道 。 
let 's take a rest . 	我們 休息 一下 吧 。 
are you hiding something ? 	你 是不是 瞞 着 我 什麼 ？ 
we had a good conversation . 	我們 談得 不錯 。 
how long will we have to wait ? 	我們 要 等 多久 ？ 
he quickly went out of the room . 	他 很快 地 走出 了 房間 。 
i agreed with him on the plan . 	對 於 這個 計劃 我 同意 他 的 意見 。 
tom refused to help mary do her homework . 	湯姆拒 絶 幫瑪麗 做 她 的 作業 。 
i 'm starting to dislike her . 	我 開始 不 喜歡 她 了 。 
i do n't like to go out when it 's dark . 	我 天黑 後 不 喜歡 出門 。 
how soon can we leave ? 	我們 過 多久 才能 離開 ？ 
who invented that ? 	那 是 誰 發明 的 ？ 
there 's no one in your bedroom . 	你 的 臥室 裏 沒有 人 。 
she quit smoking . 	她 停下 來 抽煙 。 
the teacher demon@@ strated the idea with an experiment . 	這位 老師 用 試驗 論證 了 這個 想法 。 
thanks for your reply . 	謝謝 你 的 答覆 。 
i got on the train for london . 	我 登上 去 倫敦 的 火車 。 
if it had not been for your help , i could n't have comple@@ ted the work . 	如果 不是 因爲 有 你 的 幫助 ， 我 不 可能 完成 了 這個 工作 。 
i am the fastest run@@ ner . 	我 是 最快 的 跑 者 。 
i asked him to open the window . 	我 請 他 把 窗戶 打開 。 
i do n't like to leave things up in the air . 	我 不 喜歡 讓 事情 懸而 未決 。 
we still have plenty of time left . 	我們還 剩下 很多 時間 。 
is your homework finished ? 	你 的 作業 做 完 了 嗎 ？ 
sometimes things that happen do not make sense . 	有時候 ， 發生 的 事情 並 不是 合情合理 的 。 
there was n't a soul in sight . 	一個 人影 也 看不到 。 
i 've got something you 've got to see . 	我 有 個 東西 您 該 看看 。 
tom built his own motorcycle . 	湯姆造 了 他 自己 的 摩托 車 。 
it is me that is wrong . 	是 我 錯 了 。 
that is mine . i do n't know where yours is . 	那個 是 我 的 。 我 不 知道 你 的 在 哪裏 。 
please speak more loudly . 	請 說 大聲 一點兒 。 
her only pleasure is listening to music . 	她 唯一 的 樂趣 就是 聽音樂 。 
i 'm getting ready for the worst . 	我 已經 做好 了 最壞 的 打算 。 
big fish eat little fish . 	大魚吃小魚 。 
i have a frog in my throat . 	我 的 喉嚨 裡有 一 隻 青蛙 。 
tom dea@@ lt the cards . 	Tom 處理 了 卡片 。 
please say hello to your family . 	帶 我 向 你家 人 問好 。 
the bus stop is across the street . 	公車 站牌 就 在 街 對面 。 
i ca n't blame tom for not waiting . 	我 不能 怪 湯姆 不 等 著 。 
is there any mail for me today ? 	今天 有給 我 的 郵件 嗎 ？ 
spring will come soon . 	春天 就要 來 了 。 
they both want a child . 	他 倆 想要 一個 孩子 。 
what have i ever done to tom ? 	我 對 湯姆 做 了 什麼 ？ 
i need it a@@ sa@@ p . 	我 儘快 需要 。 
he is old enough to know better . 	他 已 經長 大該 懂事 了 。 
may i be excu@@ sed from tomorrow 's class ? 	明天 的 課 我 能 不來 嗎 ？ 
i get along with my younger brother . 	我 與 我 的 弟弟 相處 融洽 。 
none of the money is yours . 	這些 錢 都 不是 你 的 。 
the population of london is much greater than that of any other bri@@ ti@@ sh city . 	倫敦 的 人口 遠遠 多 於 其他 英國 城市 的 人口 。 
to be always honest is not easy . 	要 一直 誠實 是 不 容易 的 。 
there 's no mistake . 	沒有 錯誤 。 
a consider@@ able amount of time and effort have been spent already . 	已經 花費 了 很多 的 時間 和 精力 。 
the apple tree has a beautiful blo@@ sso@@ m . 	蘋果樹 上 掛 着 美麗 的 花朵 。 
i 've finished writing the letter . 	我 已 經寫 完信 了 。 
hurry , and you will catch the train . 	快 一點 ， 你 就 能 趕上 火車 了 。 
tom is looking for someone to take mary 's place . 	Tom 正在 找 其他人 代替 Mary 。 
`` she likes music . '' `` so do i . '' 	“ 她 喜歡 音樂 。 ” “ 我 也 是 。 ” 
he never speaks unless spoken to . 	除非 有人 跟 他 說 話 ， 他 從 來 不 說 話 。 
he usually goes to work at 8 a@@ .m . 	通常 ， 他 早上 8 點去 上班 。 
you 've given me good advice . 	你給 了 我 很 好 的 建議 。 
maybe that wo n't happen . 	也許 那 沒 有 發生 。 
shut all the doors and windows . 	關閉 所有 的 門和 窗戶 。 
tom was n't as handsome as mary said he was . 	湯姆 並 不是 瑪麗 說 得 那樣 英俊 。 
how did tom get out of jail ? 	湯姆 是 如何 出獄 的 ？ 
he threw a stone at the dog . 	他 朝着 狗 扔 了 塊 石頭 。 
i have n't met her . 	我 沒有 遇見 她 。 
i am going to stay here for a couple of days . 	我將 要 在 這裡 待 幾天 。 
what 's the meaning of this word ? 	這個 字 的 意思 是 什麼 ？ 
what did you do last night ? 	你 昨天 晚上 做什麼 ? 
leave my car alone . 	不要 碰 我的車 。 
if i 've mis@@ jud@@ ged you , i 'm terri@@ bly sorry . 	如果 我 對 你 產生 誤解 ， 我 實在 抱歉 。 
tom might be a vege@@ tari@@ an . 	湯姆 可能 是 素食 者 。 
i have no particular reason to do so . 	我 沒有 特別 的 理由 去 做 。 
as soon as he sat down , he picked up the telephone . 	他 一 坐下 ， 就 拿 起 了 電話 。 
i do n't like either tea or coffee . 	我 不 喜歡 茶 也 不 喜歡 咖啡 。 
i have asked him . 	我 問過 他 。 
i 'm coming home , tom . 	我 在 回家 ， 湯姆 。 
i think you 're a lot stronger than you know . 	我 認爲 你 比 你 想象 的 更 強 。 
i have no time . 	我 沒 時間 。 
he wants to get a new dictionary . 	他 想得到 一本 新 的 字典 。 
the boy has learned to read . 	男孩 學會 了 閱讀 。 
i 've never underesti@@ ma@@ ted tom . 	我 從沒 低估 湯姆 。 
she accused me of telling a lie . 	她 指責 我 說 謊 。 
what 's your occu@@ pa@@ tion ? 	您 的 職業 是 什麼 ？ 
the teacher said that the earth is round . 	老師 說 地球 是圓 的 。 
i 'm able to speak . 	我能 說 。 
you may make use of his library . 	你 可以 利用 他 的 圖書館 。 
it was really cheap . 	它 真的 很 便宜 。 
do you have anything to say ? 	你 有 任何 話 要 說 嗎 ？ 
tom will try and stop me for sure . 	湯姆 一定 會試 着 阻擋 我 。 
do n't be disappointed . 	不要 失望 。 
keep away from the electri@@ cal equi@@ p@@ ment . 	遠離 電器 設備 。 
have you finished reading that book ? 	你 讀完 那 本書 了 嗎 ？ 
we 'll meet again . 	後會有期 。 
mother prepared lunch for me . 	媽媽 爲 我 準備 了 午飯 。 
i broke a glass when i did the dishes . 	我 做菜 時 打 了 個 玻璃杯 。 
if you 're wrong , then i 'm wrong , too . 	如果 你 錯 了 ， 那麼 我 也 錯 了 。 
did you go out last night ? 	你 昨天 晚上 出去 了 嗎 ？ 
i 'm the one who has to do this . 	我 是 必須 去 做 這事 的 人 。 
i 'm sorry i was n't able to see you when you came by today . 	我 很 抱歉 今天 您 來 的 時候 沒能 見 您 。 
i was nervous , too . 	我 也 緊張 。 
you should make an effort to stop smoking . 	你 應該 努力 去 戒煙 。 
can you explain why you were late ? 	你 能 解釋 一下 你 為 什麼 遲到 嗎 ？ 
i want to take a bath . 	我要 洗澡 。 
i will never for@@ ce you to marry him . 	我永遠 不會 逼 你 跟 他 結婚 。 
i went on reading . 	我 繼續 閱讀 。 
i walked in the woods by myself . 	我 自己 走進 了 樹林裡 。 
tom lit his ci@@ gar . 	湯姆點 了 雪茄 。 
do you still want to give me a hug ? 	你 還想給 我 一個 擁抱 嗎 ？ 
i 'm brea@@ st-@@ fe@@ eding my baby . 	我 餵 我 的 孩子 母乳 。 
where 's the dining room ? 	餐廳 在 哪裏 ？ 
he was elected mayor . 	他 被 選爲 市長 。 
i 've forgotten his name . 	我 已經 忘 了 他 的 名字 。 
let me die . 	讓 我 去 死 。 
his advice did n't help much . 	他 的 忠告 沒 起到 太大 的 作用 。 
are you a college student ? 	你 是 大學生 嗎 ？ 
tom goes to work by motorcycle . 	湯姆騎 摩托 車 上班 。 
i wo n't be fooled . 	我 不會 上當 的 。 
tom has a pretty big mouth . 	湯姆 是 一個 大 嘴巴 。 
i do not love him anymore . 	我 已經 不愛 他 了 。 
i should clean my room . 	我 應該 打掃 我 的 房間 。 
they now have three children . 	現在 他們 有 三個 孩子 。 
you run . 	你 跑 。 
tom took the concert ticket mary offered him . 	湯姆 拿 了 瑪麗 給 他 的 音樂會 票 。 
i wish i were young . 	但願 我 還年 輕 。 
i 'll admit i 'm wrong . 	我承認 我 錯 了 。 
i go to the library two or three times a week . 	我 一週 去 圖書館 兩 、 三次 。 
my sister married her high school classmate . 	我 的 姐姐 嫁給 了 她 的 高中 同學 。 
for what purpose ? 	為 了 什麼 目的 ？ 
he was paid 10,000 dollars . 	有人 付給 他 10000 美元 。 
did you buy her something for christmas ? 	你 聖誕節 買 東西給 她 了 嗎 ? 
tom hung his jacket in the hall closet . 	湯姆 把 他 的 夾克 掛 在 大廳 衣櫃 裏 。 
why are you being so secre@@ tive ? 	你 為 什麼 這麼 神祕 ？ 
may i be the first to offer my congratulations . 	或許 我 是 第一個 給 你 祝賀 的 人 。 
i 'd like three p@@ ounds of chicken . 	我要 三 磅 的 雞肉 。 
i was afraid i might be late . 	我怕 我 可能 遲到 了 。 
do you have any smaller si@@ zes ? 	你 有 任何 比較 小 的 尺寸 嗎 ? 
she made a new suit for him . 	她 做 了 一套 新 衣服 給他 。 
do you know how to drive a car ? 	您 會 開車 嗎 ？ 
i crossed the river by boat . 	我 乘船 過 了 河 。 
do n't you have anything to eat ? 	你們 有 什麼 不吃 的 嗎 ？ 
these apples look very fresh . 	這些 蘋果 看起來 很 新鮮 。 
the oranges in this bag are rotten . 	這個 袋子 裡的 柳橙都爛 了 。 
i was at the theater . 	我 在 劇場 。 
it was raining when we arrived . 	我們 到 的 時候 正在 下雨 。 
do people in your country eat rice ? 	在 您 國家 的 人 是 吃 米 飯 的 嗎 ？ 
waiter , i 'd like to order . 	服務生 ， 我要 點菜 。 
he 's a tall boy . 	他 是 一個 高大 的 男孩 。 
his cottage is on the coa@@ st . 	他 的 村屋 在 海岸 上 。 
i had her swe@@ ep my room . 	我 讓 她 打 掃 了 我 的 房間 。 
the things he says are not the least bit important . 	他 說 的話 根本 毫無 意義 。 
he is learning how to drive a car . 	他 正在 學 怎麼 開車 。 
this apple is very red . 	這 只 蘋果 非常 紅 。 
turn the radio down a little . 	把 收音機 的 聲音 關小一點 。 
i was truly astoni@@ shed . 	我 真是 驚訝 。 
the price of eggs is going up . 	蛋 的 價格 正在 上漲 。 
`` trust me , '' he said . 	“ 相信 我 。 ” 他 說 。 
this book 's new . 	這 本書 是 新 的 。 
i ca n't wait to go on a vacation . 	我 等不及 要 去 度假 。 
i speak english every day . 	我 每天 都 說 英語 。 
i 'm too sleepy to do my homework . 	我 太累 了 ， 做不了 功課 。 
real friendship is more valuable than money . 	真正 的 友誼 比 金錢 更 有 價值 。 
please remember to mail the letter . 	請 記得 把 信 寄 出去 。 
i think that 's awful . 	我 看 那 糟 透 了 。 
i am waiting for the store to open . 	我 正 等 著 這家店 開門 。 
i 'd like to invi@@ te you to the party . 	我 想 請 你 參加 派對 。 
this car is n't worth repa@@ ir@@ ing . 	這輛車 不 值得 修理 。 
i am blind in the right eye . 	我 的 右眼 瞎 了 。 
do n't play in the road . 	別 在 馬 路上 玩 。 
we swam until it got dark . 	我們 游泳 到 天黑 。 
i sell clothing on@@ line . 	我在網 路上 賣 衣服 。 
tom does n't like doing homework . 	湯姆 不 喜歡 做 作業 。 
i got a far@@ e@@ well present from everyone . 	每個 人 都 送 了 我 一份 歡送 禮物 。 
it looks like an orange . 	它 看 起來 像 橙子 。 
come in , the door 's open . 	進來 , 門是 開 的 。 
i want to see your older sister . 	我 想 見 你 姐姐 。 
maybe some other time . 	也許 下 一次 吧 。 
in a cri@@ sis , you must get in touch with your teacher . 	在 危險 的 時候 你 必須 跟 你 的 老師 聯 繫 。 
there is a computer on the table . 	桌子 上 有 一 臺 電腦 。 
let 's talk about this tomorrow . 	我們 來 討論 下 明天 吧 。 
this job does n't pay . 	這個 工作 沒有 酬勞 。 
what tri@@ ps are you planning ? 	你 在 計劃 什麼 出遊 嗎 ？ 
i 'll take you to the bus stop . 	我會 帶 你 到 公交車 站 。 
she is old enough to know better . 	她 年 紀夠 大該 懂事 了 。 
we must never con@@ fu@@ se the two . 	我們 決不能 混淆 兩者 。 
you 're still green . 	你 還 年輕 。 
i ca n't understand this at all . 	我 一點 也 不 懂 這個 。 
she liked him right off . 	她 立刻 喜歡 上 他 了 。 
do n't ask me for money . 	不要 問我要 錢 。 
you do n't need to work on sundays . 	星期天 的 時候 ， 你 不用 工作 。 
i am a stranger here . 	我 是 這裡 的 外地人 。 
he 's three years older than me . 	他 比 我 大三 歲 。 
tom had no children . 	Tom 沒有 孩子 。 
i 'm very busy today . 	我 今天 很忙 。 
tom nearly died tonight . 	湯姆 昨晚 差點 死 了 。 
you have to come with me . 	你 必須 跟 我 來 。 
i decided to buy a car . 	我 決定 買 一輛車 。 
he is going to be an engineer . 	他 將成 為 一名 工程 師 。 
he confessed to the murder . 	他 供認 了 殺人 的 罪行 。 
he has n't answered my letter yet . 	他 還 沒回 我 的 信 。 
he is a baseball player . 	他 是 個 棒球 手 。 
tom is afraid of heights . 	湯姆 恐高 。 
she cal@@ med down . 	她 冷靜 下來 。 
life is very hard . 	人生 良苦 。 
i used to eat like a pi@@ g . 	我 曾經 像 豬 一樣 吃 。 
are you saying that you give up ? 	你 是 說 你 放棄 了 嗎 ？ 
can you name one of their songs ? 	你 能夠 說出 一首 他們 的 歌 的 名字 嗎 ？ 
the baby can not use a spoon yet . 	寶寶 還 不會 使用 勺子 。 
although the government refu@@ ses to admit it , its economic policy is in ru@@ ins . 	儘管 政府 拒絕 承認 ， 它 的 經濟 政策 還是 失敗 了 。 
i do n't like the food at that del@@ i . 	我 不 喜歡 那家 熟食 店裏 的 食物 。 
i love her so much i could die . 	愛 她 愛得 要命 。 
i saw a horse pu@@ lling a car@@ t . 	我 看 見 一匹 馬 拉 著 一架 馬車 。 
tell them we 're coming . 	告訴 他們 我們 要來 了 。 
you should keep your mouth shut . 	你 應該 閉上 你 的 嘴 。 
i have nothing to do with the crime . 	這個 犯罪 和 我 一點 關係 都 沒有 。 
i learned to drive a car when i was eighteen and got a driver 's license . 	我 十八 歲 時 ， 學了 開車 、 考到 了 駕照 。 
tom apologi@@ zed for what he did . 	湯姆為 他 所 做 的 事 道歉 。 
it 's no big deal . 	這 沒什麼 大不了 的 。 
we 'll fly there in 50 minutes . 	50 分鐘 之 內 我們 將飛到 那裡 。 
i 'm innocent . 	我 是 清白 的 。 
i 'm coming to see you tomorrow . 	我 明天 會來 看 你 。 
i bought two loa@@ ves of bread . 	我 買 了 兩條 麵 包 。 
that 's right ! 	對 了 ！ 
i 'm not the boss . 	我 不是 老 闆 。 
whether he comes or not , the result will be the same . 	他來 還是 不來 ， 結果 是 一樣 的 。 
tom does n't eat red meat . 	湯姆 不吃 紅肉 
i wo n't be home next sunday . 	我下 週日 不 在家 。 
do we have enough food ? 	我們 有 足夠 的 食物 嗎 ？ 
my brother is not as tall as i was two years ago . 	我 弟弟 沒 我 兩年 前高 。 
i do n't have a good feeling about this . 	我 覺得 這 沒什麼 好 。 
europe has a smaller population than asia . 	歐洲 的 人口 比 亞洲 少 。 
tom and i are in the same class . 	湯姆 和 我 在 同一 個班裡 。 
i live here . 	我 住 在 這 。 
i 'm sorry , i di@@ al@@ ed the wrong number . 	對 不起 ， 我 撥 錯 了 號碼 。 
there was a shor@@ tage of fuel . 	燃料 短缺 。 
all of the cookies are in the shape of stars . 	所有 餅乾 都 是 星星 的 形狀 。 
we had a kid just last year . 	就 在 去年 我們 有 了 一個 孩子 。 
it needs to be repaired . 	它 需要 修理 。 
he gave it a new name . 	他 給 了 它 一個 新 名字 。 
she cut the apple with a knife . 	她 用 刀子 切 蘋果 。 
what 's wrong with my plan ? 	我 的 計畫 有 問題 嗎 ？ 
thank you , i 've had enough . 	謝謝 你 ， 我 吃 飽 了 。 
do n't bother me . 	別來 煩 我 。 
would you please explain the rules to me ? 	請 你 為 我 解釋 規則 好 嗎 ? 
where are those people from ? 	那些 人 從 哪來 的 ？ 
do you know what i 'm doing ? 	你 知道 我 在 做 什麼 嗎 ？ 
come home . 	回家 吧 。 
tom did n't doubt that there would be a lot of people there . 	湯姆 確定 那裏 會 有 很多 人 。 
is the work hard ? 	工作 困難 嗎 ？ 
i wish you 'd go . 	我 希望 你 去 。 
pass me the salt , would you ? 	把 鹽 遞給 我 好 嗎 ？ 
please do n't tell your parents this . 	請 不要 告訴 你 父母 。 
please bring me my bill . 	請 把 帳單給 我 。 
i know why tom is studying french . 	我 知道 為 甚麼 湯姆學 法語 。 
tom wondered why there was a dog in his house . 	湯姆 奇怪 爲什麼 他 的 房子 裏 有 只 狗 。 
all their efforts were in va@@ in . 	他們 的 努力 都 白費 了 。 
i want something hot to drink . 	我想 喝點熱 的 飲料 。 
we should tell children how to protect themselves . 	我們 應該 告訴 孩子 怎麼 保護 自己 。 
help yourself to a piece of cake . 	你 自己 拿 蛋糕 吃 吧 。 
i 've had to do everything by myself . 	我 必須 靠 自己 做 所有 事 。 
that 's true . 	這是 真的 。 
please knock before entering . 	進來 之前 請 敲門 。 
my mother was an alco@@ holi@@ c . 	我 母親 是 個 酒鬼 。 
why should i apologize to you ? 	爲什麼 我要 向 你 道歉 ？ 
give her the book . 	把 這 本書 給 她 。 
please translate this sentence into japanese . 	請 把 這句 話 翻譯成 日文 。 
this guy looks like a fox . 	這 傢伙 像 個 狐狸 。 
he appeared at last . 	他 終於 出現 了 。 
he was very friendly to everybody . 	他 對 每個 人 都 非常 友善 。 
i 'm feeling good this morning . 	我 今天 早晨 感覺 良好 。 
we 'll go when it qui@@ ts raining . 	雨停 了 我們 就 會 去 。 
please help me clean the house . 	請 幫 我 打 掃 房子 。 
tom 's uncle keeps a lot of sheep . 	湯姆 的 叔叔 養 了 很多 羊 。 
he does n't know how to write a letter in english . 	他 不 知道 如何 用 英語 寫信 。 
sorry , but i ca n't hear you very well . 	對 不起 ， 但 我 聽 不清 你 說 的 話 。 
he brought me to the bus stop . 	他 帶 我 到 車站 。 
he made his way to the minister . 	他 設法 當上 了 部長 。 
he can read well enough . 	他 能 讀 得 很 好 。 
who was playing ? 	誰 在 玩 ？ 
do n't you think so ? 	你 不 這麼 認爲 嗎 ？ 
i 've missed another chance . 	我 又 失去 了 一次 機會 。 
i got sick from drinking too much . 	因為 喝酒 喝太多 ， 所以 我 生病 了 。 
where is my umbrella ? 	我 的 傘在 哪 ？ 
nobody likes being laughed at . 	沒 有人 喜歡 被 人 嘲笑 。 
i am in favor of your proposal . 	我 贊成 你 的 建議 。 
not everything can be bought with money . 	不是 所有 的 東西 都 可以 用金錢 買 到 。 
i am not afraid of dying . 	我 不怕死 。 
where can i go to get a map of europe ? 	去 哪裏 可以 買到 歐洲 的 地圖 ？ 
the last person i told my idea to thought i was nu@@ ts . 	最後 一個 聽 我 說 我 的 主意 的 人 認爲 我 瘋 了 。 
admission to the museum is thirty dollars . 	博物 館入 場費 是 三十 美元 。 
tom has his own problems . 	湯姆 有 他 自己 的 問題 。 
what a beautiful flower ! 	多 漂亮 的 花 啊 ! 
i am near the station . 	我 在 車站 附近 。 
english has now become the common language of several nations in the world . 	英語 現已 成爲 世界 上 許多 國家 的 通用 語言 了 。 
he 's a professor of bio@@ logy at harvard . 	他 是 哈佛大學 的 生物學 教授 。 
i feed my cat every morning and every evening . 	每天 早晚 ， 我 給 我 的 貓 餵食 。 
tom has lived in boston for over a year . 	湯姆 住 在 波士頓 已經 一年 多 了 。 
there is not much traffic on this road . 	這條 路上 的 車輛 不多 。 
what woke you up ? 	什麼 吵醒 你 了 ? 
when i was your age , pl@@ u@@ to was a planet . 	當我 在 你 這個 年 紀時 ， 冥王星 是 行星 。 
do you study english ? 	您 學 英語 嗎 ？ 
she is always dressed in black . 	她 總 是 穿 著 黑色 的 衣服 。 
my boyfriend is a jour@@ na@@ list . 	我 男朋友 是 個 記者 。 
how are you doing in school ? 	學校 怎麼樣 ？ 
i 've never seen tom laugh . 	我 從 沒見 湯姆笑 。 
india gained in@@ depen@@ dence from britain in 19@@ 4@@ 7 . 	印度 於 1947 年 脫離 英國 獲得 獨立 。 
i finally persu@@ ad@@ ed him to buy it . 	我終 於 說 服 了 他 買 它 。 
how are you , tom ? 	你好 嗎 ， 湯姆 ？ 
the cause of the fire was un@@ known . 	火災 的 原因 不明 。 
it 's very hot in this room . 	這間 房裡 很熱 。 
that changed everything . 	那 改變 了 一切 。 
i do n't want tom to do that alone . 	我 不想 讓 湯姆 自己 做 。 
this was the most interesting book that she had ever read . 	這是 她 讀過 最 有趣 的 書 。 
she may be proud of her daughter . 	她 可以 爲 她 的 女兒 感到 驕傲 。 
wash your feet . 	洗 你 的 腳 。 
i wish you the best of luck . 	祝 你好 運 。 
why do you let tom treat you that way ? 	你 為 甚麼 讓 湯姆 那麼 對 待 你 ？ 
they refused . 	他們 拒絕 了 。 
we 're special . 	我們 很 特別 。 
someone has taken my shoes by mistake . 	有人 穿錯 了 我 的 鞋 。 
he is a bad driver . 	他 是 個 糟糕 的 司機 。 
that patient may die at any time . 	病人 隨時 會 死 。 
i wish i had seen her . 	但願 我 見過 她 。 
i 'm sorry , i forgot to do my homework . 	對不起 ， 我 忘 了 作業 這 回事 了 。 
i thought tom would want to know about that . 	我本 以爲 湯姆 願意 瞭解 這件 事 。 
i was very impressed by his story . 	我 被 他 的 故事 感染 了 。 
i succeeded in getting what i wanted . 	我 成功 地 得到 了 我 想要 的 。 
is there a hotel around here ? 	附近 有 酒店 嗎 ？ 
i plan to break up with her . 	我 打算 與 她 分手 。 
i 've been told that you 're a very compe@@ tent person . 	有人 說 你 是 個 很 有 能力 的 人 。 
when i heard that song , it remin@@ ded me of when i was a kid . 	我 聽 到 那 首歌 時 ， 它 讓 我 想起 了 我 小 的 時候 。 
tom is lucky he did n't get shot . 	湯姆 沒 被 射中 真走運 。 
will you please hold this e@@ dge ? 	能 不能 請 你 拿 着 這端 ？ 
no one understands me . 	沒有 人 理解 我 。 
it was a great sho@@ ck to me . 	這對 我 是 很大 的 震撼 。 
the mountain was covered with snow . 	這座 山 被 雪覆蓋 著 。 
someone is lying . 	有人 說謊 。 
let your hair down a little . 	稍微 隨意 一點 。 
i do n't like my hair at all . 	我 根本 不喜歡 我的頭 髮 。 
he 's my new friend . 	他 是 我 新交 的 朋友 。 
that 's my coat . 	那 是 我 的 大衣 。 
you 'd better go to bed at once . 	你 最好 馬上 去 睡覺 。 
does she speak english ? 	她 會 說 英語 嗎 ？ 
when i woke up , it was snowing . 	當我醒 來 時 ， 天正 下著雪 。 
i 've been to australia three times . 	我 去過 澳洲 三次 。 
he always plans a thing out carefully before he does it . 	他 每件 事 做 之前 都 會 細心 計劃 。 
what happened then ? 	然後發生 了 什麼 事 ？ 
his wife is quite a talented woman . 	他 老婆 很 有 才 。 
please help yourself to the cake . 	你 自己 拿 蛋糕 吃 吧 。 
keep to the right . 	靠 右側 通行 。 
we spent the weekend with friends . 	我們 和 朋友 一起 度過 週末 。 
i asked her to wait a minute . 	我 讓 她 等 了 一分鐘 。 
hope@@ fully , we 'll enjoy our china trip . 	希望 我們 會 喜歡 我們 的 中國 之 旅 。 
you should read a lot of books while you 're young . 	應該 趁 年輕 多讀 點書 。 
go at once , o@@ ther@@ wise you will be late . 	立刻 走 ， 否則 你 會 遲到 。 
i wonder whether or not tom can speak french . 	我 不 知道 湯姆會 不會 說 法語 。 
she was in america last month . 	她 上 個 月 在 美國 。 
the teacher got quite well again . 	老師 再次 恢 復 健康 了 。 
please do n't look at me like that . 	請 不要 那樣 看 我 。 
i wanted to go to the concert . 	我本 想 去 參加 音樂會 的 。 
tom went home alone . 	湯姆 一個 人 回家 了 。 
tom asked if i 'd found my key . 	湯姆問 我 找到 我 的 鑰匙 了 嗎 。 
no fe@@ wer than 50 passengers were killed . 	不下 50 個 乘客 死 了 。 
you could say that . 	你 不能 這麼 說 。 
if we were supposed to talk more than listen , we would have been given two mou@@ ths and one ear . 	如果 我們 應該 少 聽 多 說 話 , 那麼 我們 應該 得到 兩個 嘴巴 一 隻 耳朵 才 是 。 
he is able to speak five languages . 	他會 說 五種 語言 。 
i 've lost a little weight . 	我 瘦 了 一點 。 
stop bo@@ ther@@ ing me . 	不要 煩 我 。 
this is the chea@@ pest shop in town . 	這是 鎮上 最 便宜 的 商店 。 
i 'm counting on your help . 	我 指望 你 的 幫助 。 
i was the happi@@ est man on earth . 	我 曾 是 世界 上 最 幸福 的 男人 。 
they made their way through the crowd . 	他們 從 人羣 中擠 過去 了 。 
the mountain has a beautiful shape . 	這座 山有 一個 美麗 的 外形 。 
are you all ready ? 	你們 都 準備 好 了 嗎 ? 
he is a man of few words , but he always keeps his promise . 	他 這個 人話 不 多 ， 但 總是 遵守 諾言 。 
he is known as a great poet . 	他 以 一個 偉大 的 詩人聞名 。 
tom has no brothers or sisters . 	Tom 沒有 兄弟 也 沒 有 姊妹 。 
can you put some sun@@ t@@ an lo@@ tion on my back ? 	你 能 在 我 的 背上 塗些 防曬霜 嗎 ？ 
do n't be terri@@ fied . 	別 被 嚇壞 了 。 
the rumor pro@@ ved to be true . 	經過 證實 ， 謠言 是 真的 。 
i 'm fine . 	我 很 好 。 
those two are exactly a@@ like . 	那 兩個 是 一模 一樣 的 。 
which credit cards can i use ? 	我 可以 用 哪些 信用卡 ？ 
i slept on the bus . 	我 在 公交車 上 睡覺 了 。 
the youngest daughter is excep@@ tion@@ ally beautiful . 	麼 女長 得 特別 漂亮 。 
your c@@ v has really impressed me . 	你 的 履歷給 我 留下 深刻 的 印象 。 
would you like to eat something ? 	你 想 吃點 東西 嗎 ？ 
i was in the garden all afternoon . 	我 整個 下午 都 在 花園裏 。 
where is the wedding to be ? 	婚禮 在 哪兒 舉行 ？ 
i wonder if you have something to write with . 	我 懷疑 你 是否 有 東西 可 寫 。 
stay right here and relax . 	待 在 這裏 ， 放 鬆 。 
i do n't like wine . 	我 不 喜歡 紅酒 。 
fill in your name and address . 	填上 你 的 姓名 和 地址 。 
i 'll be able to as@@ sist you . 	我能 協助 你 。 
she refused my offer to help her . 	她 拒絕 讓 我 幫助 她 。 
tom has n't done anything . 	湯姆 什麼 都 沒 做 。 
he could n't get the job . 	他 無法 得到 這份 工作 。 
i have never fed my dog a banan@@ a . 	我 從 沒給 我 的 狗 喂過 香蕉 。 
i held my breath and waited . 	我 屏住 了 呼吸 等待 着 。 
i do n't know your reasons for not li@@ king tom . 	我 不 知道 你 不 喜歡 湯姆 的 理由 。 
she looks young . 	她 看起來 很 年輕 。 
excuse me , let me point out three mistakes in the above article . 	不好意思 ， 讓 我 指出 先前 文章 的 三個 錯誤 。 
you ought to have come to our party . 	你 應該 到 我們 的 派 對 的 。 
kyoto and boston are sister cities . 	京都 和 波士頓 是 姐妹 城市 。 
tom needs to up@@ date his website . 	湯姆 需要 更新 他 的 網站 。 
you can take today off . 	你 今天 可以 休假 一天 。 
you look very pale . 	你 看上去 很 蒼白 。 
it 's a sun@@ flower . 	那 是 一朵 向日葵 。 
ignor@@ e tom . 	別理 湯姆 。 
do you com@@ mu@@ te to school by bus ? 	你 搭 公車 上下 學 嗎 ？ 
you 'd better keep your money for a rainy day . 	你 最好 未雨綢繆 。 
the teacher can not have said such a thing . 	老師 不 可能 說 過 這樣 的 事 。 
let 's skip out before tom gets back . 	咱在 湯姆 回來 之前 開溜 吧 。 
two for the lunch bu@@ ff@@ et , please . 	兩人份 自助 午餐 ， 謝謝 。 
i used to play tennis in high school . 	我 高中 時 曾 打 網球 
turn on the radio , please . 	請 將 收音機 打開 。 
i know none of them . 	他們 中 的 任何 一位 我 都 不 認識 。 
exercise is good for your health . 	做 運動 有利於 健康 。 
who do you think we are ? 	你 認爲 我們 是 誰 ？ 
this suit seems really expensive . 	這 西裝 好像 真的 很貴 。 
i think my right arm is broken . 	我 想 我 的 右 手臂 斷 了 。 
do you like japanese food ? 	你 喜歡 日本 料理 嗎 ? 
she has a strong objection to my plan . 	她 強烈 反 對 我 的 計畫 。 
i want some orange juice . 	我 想要 一點 柳 橙汁 。 
we left home early in the morning . 	我們 早上 很 早就 離開家 了 。 
tom was excited to go to the concert . 	湯姆 爲 去 音樂會 而 激動 。 
i need some help with my work . 	我 在 我 的 工作 上 需要 一些 幫助 。 
i think i 'm right . 	我 想 我 是 對 的 。 
she took care of the children . 	她 照顧 孩子 們 。 
the police are investiga@@ ting the cause of the accident . 	警察 調查 事故 的 原因 。 
true love never grows old . 	真愛不會 變老 。 
japan is an extremely noisy country . 	日本 是 一個 非常 嘈雜 的 國家 。 
more coffee , please . 	請 再給 我 一點 咖啡 。 
everyone is waiting for tom . 	每個 人 都 在 等 湯姆 。 
she gave us lots to eat . 	她給 了 我們 很多 吃 的 東西 。 
it was foolish of you to accept his offer . 	你 真 笨 去 接受 他 的 提議 。 
i ca n't reach it . 	我 搆 不到 它 。 
he hates cleaning his room . 	他 討厭 打掃 自己 的 房間 。 
cows are eating grass in the mea@@ dow . 	牛 吃 牧草 。 
do you go to church ? 	你 去 教堂 嗎 ？ 
we go out together every weekend . 	我們 每個 週末 都 一起 出去 。 
i ca n't find my ticket . 	我 找 不到 我 的 票 。 
the train for bir@@ min@@ g@@ ham leaves from pla@@ t@@ form 3 . 	去 伯明翰 的 火車 從 3 號 站臺 出發 。 
he has three brothers . 	他 有 三個 哥哥 。 
we made the most of the opportunity . 	我們 盡力 地 利用 了 這個 機會 。 
a hundred years is called a century . 	一百年 被 叫做 一個 世紀 。 
let 's begin with this problem . 	從 這個 問題 開始 吧 。 
she asked how to cook the fish . 	她 問 了 怎麼 燒魚 。 
she goes to school on foot . 	她 走路 去 上學 。 
when did you change your address ? 	你 什麼 時候 更改 了 你 的 地址 ? 
it 's very easy to miss this kind of mistake . 	這種 錯誤 很 容易 被 人 忽視 。 
some of the blu@@ est water in the world is found in cra@@ ter lake . 	一些 世界 上 最 藍 的 水 在 火山 湖 。 
tom burst into tears . 	湯姆 淚流滿面 。 
i bought this yesterday . 	昨天 我 買 了 這個 。 
tom told me he was nervous . 	湯姆 告訴 我 他 緊張 。 
i looked after him for a period of time . 	我 看 了 他 一段 時間 。 
tom told me that i should n't go out alone at night . 	湯姆 跟 我 說 我 不 應該 晚上 一個 人 出門 。 
you 're ir@@ re@@ si@@ sti@@ ble . 	你 令人 難以 抗拒 。 
where is the police station ? 	警察局 在 哪裏 ？ 
i had a dream about him . 	我夢到 了 他 。 
he read the letter over and over . 	他 把 信讀 了 一遍 又 一遍 。 
it 'll cost about 10,000 yen . 	它 將花費 大約 10 , 000 日元 。 
i was tired today so i went to bed early . 	我 今天 累 ， 所以 我 睡 得 早 。 
the po@@ lar b@@ ears are dying . 	北極熊 正在 死去 。 
au@@ ck@@ land is a city in new zealand . 	奧克蘭 是 一座 新西蘭 的 城市 。 
he threw a rock into the pond . 	他 扔 了 一塊 石頭 到 池塘 裡 。 
flying is the qui@@ cke@@ st way to travel . 	搭飛機 是 最快 的 旅行 方式 。 
you have everything . 	您 全都 有 。 
there are no problems . 	沒有 問題 。 
do n't fail to mail this letter . 	不要 忘 了 寄 這 封信 。 
his son wants to be a lawyer . 	他 兒子 想當 律師 。 
i scre@@ wed up the very first note . 	我 搞 砸 了 第一 個 音符 。 
he took care of the business after his father 's death . 	在 他 父親 死後 ， 他 接管 了 公司 。 
i 'm not your mother . 	我 不是 你們 的 媽媽 。 
is this the right train for tokyo ? 	這是 開往 東京 正確 的 火車 嗎 ? 
do you have many friends ? 	你 有 很多 朋友 嗎 ？ 
it is difficult to speak chinese well . 	很難 把 中文 說 得 好 。 
i wanted to show it to you . 	我 想 把 它給 你 看 。 
welcome to your new home . 	歡迎 來 到 你 的 新家 。 
ten minutes later , our car ran out of gas . 	我們 的 車 再 過 十分鐘 就 沒油 了 。 
it was really special . 	它 真特別 。 
he must be tom 's brother . 	他 一定 是 湯姆 的 兄弟 。 
you have no fever . 	你 沒 發燒 。 
i had a vision . 	我 有 一個 願景 。 
the space race was an exciting time in history . 	太空 跑步 是 歷史 上 激動人心 的 時刻 。 
my parents ' gener@@ ation went through the war . 	我 父母 那 一代 經歷 過 戰爭 。 
he never gave up hope that he would reach that goal . 	他 從 沒放棄 達成 那個 目標 的 希望 。 
she asked him questions . 	她 問了 他 問題 。 
you 'll understand someday . 	你 有 一天 會 明白 。 
tom drank some orange juice . 	T 喝 了 點柳 橙汁 。 
what 's wrong , hon@@ ey ? 	出 什麼 事 了 ， 寶貝 ？ 
could i see you a minute , please ? 	讓 我 看 你 一會兒 好 嗎 ? 
put the book back on the shelf . 	把 書放 回書 架上 。 
try to avoid making any more trouble . 	盡量 避免 製 造 任何 更 多 的 麻煩 。 
he swam until he could swim no more . 	他游到 不能 遊 爲止 。 
come in , it 's open . 	進來 ， 門開 着 。 
it 's getting dark . i wonder if it 's going to rain . 	天變 暗 了 。 我 不 知道 是不是 要 下雨 。 
i used to go out with friends every weekend . 	我 曾經 每 週末 都 和 朋友 外出 。 
bring me something to eat . 	給我 東西 吃 。 
i know those tall girls quite well . 	我 跟 那些 高個子 的 女孩 很 熟稔 。 
how can you do this to me ? 	你 怎麼 這樣 對 我 ？ 
did you get up early ? 	你 起牀 早 嗎 ？ 
i 'd like you to go there . 	我 希望 你 去 那裡 。 
there 's an outside chance of winning . 	贏的 機會 微乎其微 。 
the most logi@@ cal place to keep your shoes is near the door . 	最合 邏輯 的 放鞋 處 是 門口 附近 。 
even children can read this book . 	即使 是 小孩 也 能 讀 這本書 。 
where are you going to eat lunch ? 	你 要 去 哪裡 吃 午飯 ？ 
how much is it ? 	它 多貴 ? 
i bought it for ten dollars . 	我花 10 美元 買 的 。 
what happened to him ? 	他 發生 了 什麼 事 ？ 
he was in good spi@@ ri@@ ts . 	他 精神 很 好 。 
i always thought that tom was a bit different . 	我 以前 總 認爲 湯姆 是 有 一些 與衆不同 的 。 
where 's the vodka ? 	伏特加 在 哪裏 ？ 
it does n't mean anything . 	這 什麼 都 說明 不了 ！ 
i went there yesterday . 	昨天 我 去 了 那裡 。 
this book is very thi@@ ck . 	這 本書 非常 厚 。 
the chicken is under@@ cooked . 	雞肉 還不夠 熟 。 
i succeeded in getting what i wanted . 	我 贏得 了 我 想要 的 。 
j@@ st stands for japan stan@@ dar@@ d time . 	JST 代表 日本 標準 時間 。 
it wo n't take long to finish the job . 	完成 這個 工作 不會 花太 長時間 。 
speak clearly . 	講 清楚 。 
knowledge is power . 	知識 就是 力量 。 
do n't he@@ si@@ tate to ask questions . 	不要 猶豫去 問問題 。 
he bought his daughter a dress . 	他 買 了 一件 洋裝給 他 女兒 。 
birds sing . 	鳥兒 歌唱 。 
you do n't need a gun . 	你 不 需要 槍 。 
only 3 out of the 9@@ 8 passengers survived . 	98 名 乘客 只有 3 人生 還 。 
help us reach our goal . 	幫助 我們 達成 目標 。 
you must be careful not to make him angry . 	你 要 小心 別 惹 他 生氣 。 
he is a thief . 	這是 一個 小偷 。 
i ache all over . 	我 全身 痠痛 。 
please take more care in the future . 	請 你 將來 注意 點 。 
do you need an ambu@@ lance ? 	你 需要 救護車 嗎 ? 
she teaches us french . 	她 教 我們 法語 。 
i wish she had come last night . 	要是 她 昨晚 來 就 好 了 。 
this is really terrible . 	這真 可怕 。 
i 'm very hungry now . 	我現 在 非常 餓 。 
english is taught in most countries . 	大部份 的 國家 都 教英語 。 
each student has a lo@@ ck@@ er . 	每個 學生 都 有 一櫃子 。 
if he were a little younger , he would be e@@ ligi@@ ble for the post . 	如果 他 年輕 一點 ， 他 將 很 適合 這個 職位 。 
tom has never been in prison . 	湯姆 從 沒 進過 監獄 。 
tom stopped me from entering the bank . 	湯姆 阻止 我進 銀行 。 
he studies chinese as well . 	他 也 學習 漢語 。 
where do you work now ? 	你 現在 在 哪裏 工作 ？ 
my mother bought two bottles of orange juice . 	我 母親 買 了 兩瓶 橙汁 。 
i want to see your mother . 	我 想 看看 你 的 母親 。 
we were in danger of losing our lives . 	我們 曾 有 失去 生命 的 危險 。 
everything 's normal . 	一切 正常 。 
i will never see him again . 	我永遠 不會 再 看到 他 。 
i wish you could come with us . 	但願 你 可以 跟 我們 一起 來 。 
he was playing tennis all day . 	他 整天 打 網球 。 
whose is this bicycle ? 	這輛 自行車 是 誰 的 ？ 
come whenever you want to . 	什麼 時候 想來 就 過來 吧 。 
i bought it last week . 	我 上 週買 了 它 。 
i finally found a job . 	我 終於 找到 工作 了 。 
he drives his own car . 	他開 他 自己 的車 。 
tom said he needed money . 	湯姆 說 他 需要 錢 。 
we have nothing in common . 	我們 沒有 任何 共同 之處 。 
he spoke for one hour . 	他 講 了 一 小時 。 
i 'll boil the potatoes for you . 	我 為 你 煮 馬 鈴薯 。 
she speaks both english and french . 	她 會 講英語 和 法語 。 
my father retired at the age of 6@@ 5 . 	我 的 父親 65 歲 的 時候 退休 了 。 
i 'm glad i could help you . 	能夠 出 一份 力太好 了 。 
my father has five siblings . 	我 父親 有 五個 兄弟 姐妹 。 
my aunt made me a new skirt . 	我 嬸 嬸 做 了 一條 新 裙子 給我 。 
there are four sea@@ sons in one year . 	一年 有 四季 。 
i have n't seen you for ages . do you remember when i saw you last ? 	好久 不見 了 。 記得 上次 我 什麼 時候 看見 你 的 嗎 ？ 
this one 's yours . 	這個 是 你 的 。 
all of my friends got asked to dance except me . 	除了 我 ， 其他人 都 被 邀請 去 跳舞 了 。 
can you use a computer ? 	您 會 使用 計算機 嗎 ？ 
is that what it 's called ? 	那 就是 它 的 叫法 嗎 ？ 
i must return home within a week . 	我 得 要 在 一 週內 回家 。 
he made fun of me in public . 	他 在 公共 場合 取笑 了 我 。 
there was a cottage on the side of the hill . 	山坡 上 有 一個 茅屋 。 
he lost his eyesight in the accident . 	他 在 意外 中 失明 了 。 
there were few people on the beach . 	沙灘 上 的 人 非常少 。 
a lot of trees were cut down . 	很多 樹 被 砍 倒 。 
maybe tom just got nervous . 	可能 湯姆 緊張 了 。 
i like playing sports . 	我 喜歡 運動 。 
the teacher ga@@ th@@ ered his students around him . 	老師 把 他 的 學生們 聚集 在 他 周圍 。 
this house belongs to my uncle . 	這棟 房子 屬 於 我 的 叔叔 。 
the area was quiet . 	這地區 很安靜 。 
i bought a new television . 	我 買 了 臺 新 電視機 。 
perhaps she will come tomorrow . 	也許 她 明天 會來 。 
do n't let anyone press this button . 	別 讓 任何人 按 這個 按鈕 。 
do you know a good restaurant ? 	你 知道 一個 好 飯店 嗎 ？ 
we took a walk along the river . 	我們 沿著河 散步 。 
what 're you after ? 	你 想要 什麼 ？ 
tom hung the cal@@ en@@ da@@ r on the wall . 	湯姆 把 日 曆 掛 在 牆上 。 
i will lend you this dictionary . 	我會 借給 你 這本 字典 。 
tom is swimming . 	湯姆 在 游泳 。 
i 'm amazed at his ra@@ pi@@ d progress in english . 	我 被 他 英語 的 快速 進步 驚呆 了 。 
why ca n't you come ? 	你 為 什麼 不能 來 ? 
would you like to leave a message ? 	你 要 留言 嗎 ？ 
i looked , but i did n't see anything . 	我 看過 了 , 但是 沒 看到 什麼 東西 。 
tom seems to speak french better than before . 	湯姆 講 法語 看來 比 以前 好 。 
i have no place to sleep tonight . 	我 今晚 沒 地方 睡覺 。 
you must go outside if you want to smoke . 	如果 您 想 抽菸 的話 ， 您 必須 出去 。 
what time will you leave ? 	你 什麼 時候 離開 ？ 
i am not a wi@@ tch . 	我 不是 巫婆 。 
there was a castle here many years ago . 	許多年 前 這裏 有 一座 城堡 。 
he ca n't seem to understand that poem . 	他 似乎 無法 理解 那首 詩 。 
all at once , i heard a cry . 	突然 ， 我 聽到 了 一聲 喊叫 。 
i want the same jacket as you are wearing . 	我 也 想要 和 你 身上 那件 同樣 的 外套 。 
wi@@ res are used to conv@@ ey electricity . 	電線 被 用 來 運送 電力 。 
do n't ask tom any questions about his job . 	別問 湯姆 他 的 工作 的 問題 。 
these apples are very big . 	這些 蘋果 很大 。 
they only sell women 's shoes here . 	這裏 只賣 女鞋 。 
may i ask some questions ? 	我 可以 問 一些 問題 嗎 ? 
we need to make a plan . 	我們 需要 做 計劃 。 
`` do you speak german ? '' `` no , i do n't . '' 	" 你 說 德語 嗎 ? " " 不 ， 我 不 說 。 " 
he is not the man that he was when i first knew him . 	他 已經 不是 我 最初 見 他 那時 的 那個 人 了 。 
i do n't think tom is going to be too much help . 	我 認爲 湯姆 幫不上 大忙 。 
he talks as if he knows everything . 	他 說 起話 來 好像 他 什麼 都 知道 。 
they have been married two years . 	他們 已經 結婚 兩年 了 。 
i think tom is a@@ th@@ le@@ tic . 	我 認爲 湯姆 好 運動 。 
may i go to the bathroom ? 	我 可以 去 洗手 間 嗎 ？ 
he 's always been kind to me . 	他 總是 對 我 很 親切 。 
he has a lot of original ideas . 	他 有 很多 獨到 的 見解 。 
he 's doing his best . 	他 在 全力以赴 。 
children should drink milk every day . 	孩子 們 應該 每天 喝 牛奶 。 
he likes fishing . 	他 喜歡 釣魚 。 
in the light of what you told us , i think we should re@@ vi@@ se our plan . 	根據 你 所說 的話 ， 我 認爲 我們 應該 重新 審視 我們 的 計劃 。 
i ca n't find him anywhere . 	我 在 哪兒 都 沒 找到 他 。 
this message does n't make sense . 	這個 消息 沒有 道理 。 
we accept che@@ cks . 	我們 接受 支票 。 
tom has a girlfriend in boston . 	Tom 有個 在 波士頓 的 女友 。 
my uncle lived abroad for many years . 	我 叔叔 住 在 國外 很多年 了 。 
i am almost 18@@ 0 centi@@ meters tall . 	我 差不多 180 公分 高 。 
it had to be tom that did that . 	一定 是 湯姆 做 的 。 
this is the big@@ gest car in the world . 	這是 世界 上 最大 的 車 。 
did you rent an apartment ? 	你 租 房子 了 嗎 ？ 
foreign in@@ ve@@ sto@@ rs with@@ drew their money from america . 	外國 投資者 從 美國 收回 他們 的 錢 。 
i asked him where he was going . 	我問 了 他 要 去 哪裡 。 
industry as we know it today did n't exist in those days . 	我們 今天 所 認識 的 工業 在 那個 時代 不 存在 。 
it was a very stupid decision . 	這是 一個 十分 愚蠢 的 決定 。 
what is the total amount of money you spent ? 	你 一共 花 了 多少 錢 ？ 
your order has been sub@@ mi@@ tted . 	您 的 訂單 已經 提交 了 。 
this little girl let the birds escape . 	這個 小女孩 讓 小 鳥 脫 逃 了 。 
you 're not fast enough . 	你 不夠 快 。 
she had died before i arrived . 	她 在 我 到 達 之前 去世 了 。 
this dress cost me over 4@@ 0,000 yen . 	這件 衣服 花 了 我 40000 日元 。 
who invited you guys ? 	誰 邀 請 了 你 們 ？ 
stop shooting . 	停止 射擊 。 
who do you think i am ? 	你 把 我 當 什麼 啦 ？ 
do you smoke ? 	您 吸菸 嗎 ？ 
tom did n't have a fever this morning . 	湯姆 今天 早上 沒有 發燒 。 
my father is reti@@ ring next spring . 	我 爸爸 明年 春天 就要 退休 了 。 
let 's as@@ su@@ me that 'll happen . 	讓 我們 假定 那會 發生 。 
i would like to help you . 	我 願意 幫 你 。 
he will be back in a second . 	他 很快 就 會 回來 。 
we got up at dawn to avoid a traffic jam . 	我們 黎明 時 起牀 以 避開 交通 堵塞 。 
i 'm sorry . i got the wrong number . 	對 不起 ， 我 拿 錯 了 號碼 。 
this desk is mine . 	這張 書桌 是 我 的 。 
tom wrote his name in the sand with a stick . 	湯姆 用 棍子 在 沙上 寫 了 他 的 名字 。 
he 's sitting at an empty table . 	他 坐在 一張 空 桌旁 。 
he tried to kill himself . 	他 試圖 自殺 。 
she is a famous singer . 	她 是 一個 著名 的 歌手 。 
he got hurt when he fell down . 	他 跌倒 的 時候 受 了傷 。 
have you finished your homework ? 	你 做 完作業 了 嗎 ？ 
it snowed for ten con@@ secu@@ tive days . 	雪 持續 下 了 十天 。 
i always take a bath before going to bed . 	我 睡覺 前 總要 洗個 澡 。 
he seldom , if ever , goes to church . 	他 很少 ， 如果 有 的 話 ， 去 教堂 。 
my father walks . 	我 爸爸 走路 。 
my plan is to buy a car . 	我 打算 買輛車 。 
iron the inside of co@@ ll@@ ars first , and then the outside . 	先 熨燙 領子 的 裏面 ， 然後 是 外面 。 
what goes up must come down . 	會起 必會落 。 
the fact is that he did n't even take the exam . 	實際上 他 根本 沒有 去 考試 。 
it took us a long time to decide what we really wanted to do . 	我們 花 了 很長 時間 決定 我們 真正 想 的 事 。 
this pen does n't write well . 	這 支筆 不太好 用 。 
i do n't think it 's going to be easy to find tom . 	我 認爲 ， 要 找到 湯姆 可不 容易 。 
that 's the other reason i 'm here . 	那 是 我 在 這裏 的 另外 一個 理由 。 
i wish i knew where he was ! 	但願 我 知道 他 在 哪裡 。 
i do n't like the way he talks . 	我 不 喜歡 他 講話 的 樣子 。 
none of them could understand what she was im@@ pl@@ ying . 	他們 沒 有人 瞭解 她 暗示 什麼 。 
our native language is japanese . 	我們 的 母語 是 日語 。 
he is now either in rome or in paris . 	他 不是 在羅馬 ， 就是 在 巴黎 。 
it 's very special . 	它 很 特別 。 
i work too much . 	我 工作 得太多 了 。 
tom came to the conclu@@ sion that no matter what he did , mary would n't like it . 	湯姆 得出 無論 他 做 什麼 ， 瑪麗 都 不會 喜歡 的 結論 。 
he loves to fish . 	他 酷愛 釣魚 。 
he goes to school to study every day . 	他 每天 去 學校 學習 。 
why do n't we have dinner ? 	為 甚麼 我們 不吃 晚飯 ？ 
why did you buy a japanese car ? 	你 為 甚麼 買 日本 車 ？ 
he has been dead for ten years . 	他 已 經死 了 十年 。 
i wish that tom would agree to do that . 	我 希望 湯姆能 同意 。 
they got to the hotel after dark . 	天暗 後 他們 到 了 酒店 。 
tom is out of your lea@@ gue . 	湯姆 不 在 你 的 聯盟 裏 。 
what time did you get up this morning ? 	你 今天 幾點 起 的 牀 ？ 
my father takes a walk every morning . 	我 父親 每天 早上 去 散步 。 
it can be dangerous . 	它 有 危險 。 
when was it built ? 	它 是 什麼 什麼 時候 蓋 的 ？ 
i studied for a while this morning . 	我 今天 早上 讀 了 一會兒 書 。 
i 'm not going to do anything to you . 	我 不會 對 你 做 任何 事 。 
let 's keep in touch . 	讓 我們 保持 聯絡 。 
it was not very cold yesterday . 	昨天 不是 很 冷 。 
you 're the one who suggested that we do that together . 	你 是 那個 建議 我們 一起 做 那件 事 的 人 。 
the house is not occupied now . 	房子 現在 沒 被 佔 住 。 
mars is a planet . 	火星 是 一顆 行星 。 
my aunt gave me an album . 	我 姑姑 給了 我 一本 相簿 。 
i 'm thirsty . 	我渴 了 。 
he runs a supermarket in the town . 	他 在 這個 鎮上 經營 一家 超級 市場 。 
i want to see you again . 	我 希望 再次 見 到 你 。 
could you check the tire pressure ? 	你 能 檢查 一下 這個 輪胎 的 氣壓 嗎 ？ 
who are you vo@@ ting for ? 	你 投給 誰 ？ 
he will play baseball tomorrow . 	他 明天 將打 棒球 。 
i hur@@ ried in order to catch the first train . 	我 匆匆忙忙 ， 爲的是 能 趕上 第一 班 火車 。 
do you plan to eat all of that yourself ? 	你 打算 自己 一人 把 它 全部 吃 了 嗎 ？ 
did you miss me ? 	你 想 我 了 ？ 
i have a high opinion of this book . 	我 對 這本書 評 儥 很 高 。 
what do you suppose this could be ? 	你 認爲 這是 什麼 ？ 
let 's go out and have some fun tonight . 	我們 今晚 一起 出去 找 樂子 吧 。 
it is really cheap . 	它 真的 很 便宜 。 
that novel is n't for children . 	那本 小 說 不 適合 兒童 。 
i do not for a moment think you are wrong . 	我 從沒 認爲 你 錯 了 。 
he is no fool . 	他 不是 傻子 。 
so , what 'll you give me ? 	那 你 會 給 我 什麼 ？ 
we know so little about you . 	我們 對 你 知道 得 不 多 。 
nobody supp@@ or@@ ted her . 	沒人 支持 她 。 
do n't make stupid jokes . 	開 什麼 國際 玩笑 。 
i 'll give you a book . 	我會給 你 一本 書 。 
he is making prepar@@ ations for a trip . 	他 正在 籌備 一次 旅行 。 
she whispered something into his ear . 	她 在 他 耳邊 低聲 說 話 。 
tom put down his pencil . 	湯姆 放下 他 的 鉛筆 。 
when are you going home ? 	你 什麼 時候 要 回家 ? 
i go to bed very early . 	我 很 早就 去 睡覺 。 
who 's your most interesting friend ? 	你 最 有趣 的 朋友 是 誰 ？ 
i do n't need anyone . 	我 誰 也 不 需要 。 
i can play chop@@ in . 	我會彈 蕭邦 。 
he rep@@ lied that he did not know . 	他 回答 說 他 不 知道 。 
she went into her room to change her dress . 	她 進 了 她 的 房間 換 裙子 。 
she was in a hurry to see her father . 	她 急於 見 她 的 父親 。 
i think he 's a great writer . 	我 認爲 他 是 位 偉大 的 作家 。 
everybody desi@@ res happiness . 	每個 人 都 嚮往 幸福 。 
i 'm not a beg@@ gar . 	我 不是 乞丐 。 
i 'm going to go sit down . 	我要 坐下 。 
that 's a shame . 	那 是 一個 恥辱 。 
the blanket is still wet . 	這個 毯子 還是 溼 的 。 
we have a special connection . 	我們 有 特殊 聯 繫 。 
this is a picture of my mother . 	這張 是 我 媽媽 的 照片 。 
i still have n't found anything . 	我 還 什麼 都 沒 找到 呢 。 
please wash my back . 	請 幫 我 洗 背 。 
i think someone 's knocking on the door . 	我 想 有人 在 敲門 。 
i was born in 19@@ 88 . 	我 生於 1988 年 。 
he put his hands in his po@@ ckets . 	他 把手 插進 口袋 裡 。 
he drank very little of the water . 	他 喝 很少 的 水 。 
take your time . 	你 可以 慢慢來 。 
do you often travel abroad ? 	你 經常 去 國外 旅行 嗎 ？ 
my mother never gets up early . 	我 的 母親 從 不 早起 。 
could you do me a favor ? 	請 你 幫 我 一個 忙 好 嗎 ？ 
let 's sing the song in english . 	讓 我們 唱 英文 歌曲 。 
he has decided to become a teacher . 	他 已經 決定 要 成為 一名 教師 。 
i have to take medicine . 	我 必須 吃藥 。 
my pre@@ mon@@ i@@ tion turned out to be right . 	我 的 預感 被 證明 是 正確 的 。 
every man has his price . 	每個 人 都 有 個價 。 
give me your opinion , please . 	請給 我 你 的 意見 。 
i will stay until tomorrow . 	我會 待 到 明天 。 
i 'll stay with tom until you get back . 	你 回來 之前 我會 跟 湯姆 在 一起 。 
the j@@ et lan@@ ded at tokyo . 	這架 客機 降落 在 東京 了 。 
she knows your mother very well . 	她 對 你 的 母親 很 熟悉 。 
i like eg@@ g@@ plan@@ t . 	我 喜歡 茄子 。 
if you hurry you can still make the train . 	如果 你 抓緊 ， 你 還 能 趕上 火車 。 
you were at my wedding . 	你 出席 了 我 的 婚禮 。 
i 'd like to ask you a few more questions . 	我想 問再 你 幾個 問題 。 
i have a friend whose father is a famous writer . 	我 有 個 朋友 的 父親 是 知名 的 作家 。 
please come back home . 	請 回家 。 
jazz fu@@ sion is a com@@ b@@ ination of rock and jazz . 	融合 爵士 是 搖滾樂 與 爵士 樂 的 融合 。 
she pretended to be a student . 	她 假裝 是 學生 。 
i met a friend at the airport . 	我 在 機場 見 了 個 朋友 。 
my brother can drive a car . 	我 哥哥 會 開車 。 
i arrived two weeks ago . 	我 在 兩 週前 到 了 。 
i 'll never forget going to hawaii with her . 	我 永遠 不會 忘記 那次 跟 她 一起 去 夏威夷 。 
it is rude to laugh at others . 	嘲笑 別人 是 無禮 的 。 
who does this suitcase belong to ? 	這個 手提箱 是 誰 的 ? 
i paid the bill . 	我 買 了 單 。 
everybody is supposed to know the law , but few people really do . 	每 一個 人 都 應該 知法 懂法 ， 但是 真正 能 做到 的 人 卻 很少 。 
i do n't know where he comes from . 	我 不 知道 他 從 哪裡 來 。 
i do n't know . 	我 一無所知 。 
i have already finished reading this book . 	我 已 經讀 完 了 這本書 。 
this summer i went on vacation in scotland . 	這個 夏天 ， 我 去 蘇格蘭 度假 了 。 
i saw him swim across the river . 	我 看 見 他 遊過 了 河 。 
my father will come home at the end of this week . 	我 爸爸 會 在 這 週末 回家 。 
my brother is small but strong . 	我 哥哥 雖然 矮小 可是 很 強壯 。 
is it near your house ? 	它 在 你家 附近 嗎 ？ 
he did not appear until about noon . 	直到 快要 中午 前 他 都 沒 出現 。 
this is an exception to the rule . 	這是 一個 例外 。 
mary is very cute , is n't she ? 	馬力 很 可愛 ， 不是 麼 ？ 
i 've got a lot of questions . 	我 有 許多 問題 。 
swimming at night is dangerous . 	夜裏 游泳 很 危險 。 
no problem . 	沒 問題 。 
the regi@@ stration period is already over . 	報名 時間 已 經過 了 。 
do you want some company ? 	你 想要 夥伴 嗎 ？ 
do n't you remember what you said ? 	自己 說 過 的話 都 不 記得 了 嗎 ？ 
i do n't have any change . 	我 沒 任何 零錢 。 
come on , touch it . 	來 吧 ， 摸 一下 。 
tom does n't know what he should do . 	湯姆 不知所措 。 
japan is famous for mt . fuji . 	日本 以 富士山 聞名 。 
is it cheaper to call after 9@@ :00 ? 	九點 以後打 電話 比 較 便宜 嗎 ？ 
i am the fastest run@@ ner . 	我 是 跑 得 最快 的 人 。 
those are their books . 	這是 他們 的 書 。 
this is my book . 	這 是 我 的 書 。 
i hope everything goes well . 	我 希望 萬事如意 。 
nobody watches her . 	誰 也 沒 在 看 她 。 
you should n't smoke so much . 	你 不該 抽 那麼 多煙 。 
do you want to go to the station with me ? 	要 不 一起 到 車站 去 ？ 
i do n't know what tom got . 	我 不 知道 湯姆 拿到 了 甚麼 。 
i always feel blue on mondays . 	我 每個 星期一 都 覺得 很 憂鬱 。 
she du@@ sts the furniture every day . 	她 每天 擦拭 傢俱 的 灰塵 。 
i have n't quite finished eating . 	我 還沒有 完全 吃 完 。 
i enjoyed talking with him at the party . 	在 派對 中 我 和 他 聊 得 很 開心 。 
where 's my wife ? 	我 的 妻子 在 哪裡 ？ 
spring is my favorite season . 	春天 是 我 最 喜歡 的 季節 。 
tom has three cats . 	Tom 有 三 隻 貓 。 
we have a party tomorrow evening . 	明天 晚上 我們 有 一個 派 對 。 
it all depends on the weather . 	一切 都 取決 於 天氣 。 
i love spending time with tom . 	我 喜歡 花 時間 和 Tom 在 一起 。 
although it is snowing , i must go . 	雖然 正在 下雪 ， 但是 我 也 非 去 不可 。 
i 'm going to the bank . 	我要 去 銀行 了 。 
tom ca n't tell mary his real feelings . 	湯姆 不能 把 他 的 真實 感受 告訴 瑪麗 。 
he likes to listen to the radio . 	他 喜歡 聽 廣播 。 
tom is esca@@ ping . 	湯姆 在 逃跑 。 
you should make good use of this opportunity . 	你 要 好好 把握 這個 時機 。 
tom is working hard . 	湯姆 在 努力 工作 。 
i still prefer to write letters by hand . 	我 更 喜歡 用手 寫信 。 
i 'll be your first patient . 	我將 是 你 的 第一 個 病人 。 
move the chair n@@ ear@@ er to the desk . 	把 椅子 挪一 挪 靠近 桌子 。 
his quick temper will get him in trouble one day . 	他 的 急 脾氣 遲早 會 惹禍 上身 。 
what is your phone number ? 	你 電話號碼 是 多少 ？ 
we are sorry we ca n't help you . 	我們 很 遺憾 沒能 幫助 你們 。 
you may sit wherever you like . 	你 喜歡 坐 哪兒 就 坐 哪兒 。 
she is a teacher . 	她 是 女 教師 。 
you look sleepy . 	你 看起來 很困 了 。 
we 'll talk about it tomorrow . 	我們 明天 討論 它 。 
i 'm und@@ re@@ ssing . 	我脫 衣服 。 
the project was a great success . 	該計劃 是 一個 大 成功 。 
i got a letter from her today . 	我 今天 收到 了 她 的 信 。 
tom , we have to talk . 	湯姆 ， 我們 必須 談談 。 
where are you right now ? 	你現 在 在 哪裡 ？ 
how is it going with your family ? 	你 打算 和 你 的 家人 去 做 什麼 ？ 
do n't throw ro@@ cks into the river . 	不要 往河裡 扔 石頭 。 
this book is popular with students . 	這本書 受到 學生 的 歡迎 。 
i would like to speak english fluently . 	我想講 一口 流利 的 英語 。 
he has no manners at all . 	他 一點 禮貌 也 沒 有 。 
tom does n't want to go alone . 	湯姆 不想 一個 人 走 。 
the embassy is located next to the su@@ pre@@ me cou@@ rt . 	大使館 就 在 最高法院 旁邊 。 
what did you do last christmas ? 	去年 聖誕節 做 了 什麼 了 ？ 
i got to the station this morning . 	我 今天 上午 到 了 車站 。 
did you bring them ? 	你 把 它們 帶來 了 麼 ？ 
we ought to obey the law . 	我們 必須 遵紀守法 。 
i do not love him any longer . 	我 已經 不愛 他 了 。 
i like po@@ p music . 	我 喜歡 流行 音樂 。 
could you carry my bags for me ? 	你 可以 幫 我 提 我 的 袋子 嗎 ? 
it would appear that you 're wrong . 	你 似乎 錯 了 。 
she is far better today than yesterday . 	她 今天 比 昨天 要 好 很多 。 
i was in london last month . 	上個 月 我 在 倫敦 。 
i 'm afraid i ca n't help you . you must ask someone else . 	我 擔心 可能 幫不了 你 ， 你 需要 找 其他人 幫忙 。 
she cried her heart out . 	她 哭 得 肝腸寸斷 。 
the fire was out . 	火 熄滅 了 。 
tom started singing . 	湯姆 開始 唱歌 。 
can you do some shopping for me ? 	你 能 幫 我 買些 東西 嗎 ？ 
prices went up . 	物價 上 漲 。 
we have no idea what to do . 	我們 不 知道 要 做 甚麼 。 
would you like a cup of coffee ? 	你 要 來 杯 咖啡 嗎 ? 
call me if you dis@@ cover anything . 	如果 你 發現 什麼 ， 請 打給 我 。 
i am happi@@ est when i am reading . 	當我 閱讀 的 時候 ， 我 最快 樂 。 
when did your father come home ? 	你 爸爸 什麼 時候 回家 ？ 
i 've been there a couple of times . 	我 去過 那裡 幾次 。 
why should it be different ? 	爲什麼 它 應該 要 變得 不 一樣 ？ 
he entered the army . 	他 加入 了 陸 軍 。 
would you mind saying that once more ? 	請 你 再 說 一次 好 嗎 ？ 
i have already changed my clothes . 	我 已 經換 了 我 的 衣服 。 
you deserve to succeed . 	你 的 成功 是 應得 的 。 
english has spread all over the country . 	英語 已經 普及 全國 。 
how 's it going ? 	你們 好 嗎 ？ 
i have no doubts . 	我 沒有 疑問 。 
tom is so hot . 	湯姆 非常 性感 。 
it will cost you more to go by plane . 	搭飛機 將花 你 比 較 多 的 錢 。 
take whatever you like . 	你 喜歡 什麼 就 拿 吧 。 
i 'm a foreigner . 	我 是 一個 外國人 。 
are you writing a letter ? 	你 在 寫 信 嗎 ? 
you do n't have to eat . 	你 不必 吃 。 
may i see you in private ? 	我們 能 私下 見 見 嗎 ？ 
there is no hope of his reco@@ very . 	他 沒 有 希望 痊 癒 了 。 
i do n't want to live my life in fear . 	我 不想 在 恐懼 中 生活 。 
may i have a bus schedule ? 	我 可以 有 張公車 的 時刻表 嗎 ？ 
she makes all her own clothes . 	她 的 衣服 全部 都 是 她 自己 做 的 。 
how long have you been working here ? 	從 什麼 時候 開始 您 就 這裏 工作 着 的 呢 ？ 
when is your bed@@ time ? 	你 什麼 時候 睡覺 ？ 
in doing anything , you must do your best . 	做 任何 事 ， 你 必須 要 做到 最好 。 
how horri@@ ble ! 	真 糟糕 ！ 
i know him . 	我 認識 他 。 
please show your ticket . 	請 出示 您 的 票子 。 
my father does n't like soccer . 	我 爸爸 不 喜歡 足球 。 
we have no reason to be ashamed . 	我們 沒 理由 害臊 。 
the sky was completely dark . 	天空 完全 變黑 了 。 
he was absent from school yesterday . 	他 昨天 沒來 上學 。 
she taught music for thirty years . 	她 教 了 三十年 的 音樂 。 
i felt good tonight . 	我 今晚 感覺 良好 。 
i see you found your bag . 	我見 你 找到 了 你 的 包 。 
we went to the mountains to sk@@ i . 	我們 去 山上 滑雪 。 
i wish i had a better memory . 	但願 我 有 好 一點 的 記憶力 。 
i go to the country every summer . 	我 每年 夏天 都 去 鄉 下 。 
she had a little money . 	她 有 一點 錢 。 
they love each other . 	他們 彼此 相愛 。 
what are you doing down there ? 	你 在 那裏 幹什麼 ？ 
if you do n't hurry , you 'll miss the train . 	如果 你 不 抓緊 的話 ， 你 就 會 趕不上 火車 。 
hurry up , or you will miss the train . 	快點 ， 不然 你 就要 錯過 火車 了 。 
he wrote a book about a jun@@ gle ad@@ venture . 	他 寫 了 一本 關於 叢林 冒險 的 書 。 
i wrote down that telephone number . 	我 寫 下 了 那個 電話 號碼 。 
i 'll see you next month . 	我 下個 月 會 來 看 你 。 
take the p@@ an off the fire . 	把 平底 鍋離火 。 
i 've never climbed mt . fuji . 	我 從 來 沒 有 爬過 富士山 。 
no matter what i do , she says i can do better . 	不論 我 做 什麼 ， 她 都 說 我 能 做 得 更好 。 
it looks like the dog wants something to eat . 	那 隻 狗 看 起來 好像 想 吃 東西 。 
tom is leaving boston tomorrow . 	湯姆 明天 離開 波士頓 。 
it is wrong to tell a lie . 	說謊 是 錯誤 的 。 
i desp@@ ise you . 	我 鄙視 你 。 
tom does n't talk much . 	湯姆 說話 不多 。 
how can i reach you ? 	我 怎樣 才能 連絡 到 你 ? 
the war has not ended . 	戰爭 還 沒 結束 。 
how much money do you have hi@@ d@@ den under your bed ? 	你 在 你 的 牀 下面 藏 了 多少 錢 ？ 
that mountain is covered with snow . 	這座 山 被 雪 所 覆蓋 。 
it has been three months since he left japan . 	自從 他 離開 日本 已經 有 三個 月 了 。 
do you think i 'm joking ? 	你 覺得 我 是 在 開玩笑 嗎 ？ 
eat a lot of vegetables . 	多吃點 蔬菜 。 
is n't this weather just great ! 	天氣 真是 太好 了 ！ 
he is the chief of my department . 	他 是 我 部門 的 主管 。 
everyone wants to meet you . you 're famous ! 	大家 都 想 見到 你 ， 你 太 有名 了 ！ 
she plays the violin very well . 	她 小提琴 演奏 得 非常 好 。 
you may go home now . 	你現 在 可以 回家 了 。 
he was jealous of my success . 	他 嫉妒 我 的 成功 。 
read lesson 10 from the beginning . 	從 第十 課 的 開頭 讀起 。 
it 's the only thing i can think of . 	這 是 我 唯一 能 想到 的 事 了 。 
i never thought it would come to this . 	我 從沒 想過 它 會 變成 這樣 。 
where is the problem ? 	哪裡 有 問題 ? 
can i speak to the head nurse ? 	我能 跟 護士長 說 話 嗎 ? 
i borrow money . 	我 借 錢 。 
tickets are available now . 	現在 有票 。 
the poor girl went blind . 	這可憐 的 女孩 瞎 了 。 
she goes to a@@ er@@ o@@ bi@@ cs once a week . 	她 每 星期 去作 一次 健美操 。 
what do you usually do in your spare time ? 	你 在 閒暇 的 時候 一般 做什麼 ？ 
i 'll come back . 	我會 回來 的 。 
could you put this report into italian for me ? 	你 可以 為 我 把 這份 報告 翻譯成 意大利文 嗎 ？ 
i 've just started playing tennis . 	我剛 開始 打 網球 。 
he has a large family . 	他 有 一個 大家庭 。 
he knows how to cap@@ ti@@ va@@ te his audience . 	他 知道 如何 去 吸引 他 的 聽眾 。 
she is only a child . 	她 只是 個 孩子 。 
i do n't think tom is serious . 	我 不覺 得 湯姆 是 認 真的 。 
he 's bound to forget . 	他 準會 忘 。 
he has had a c@@ rush on her . 	他 一直 暗戀 着 她 。 
she was wearing dark brown shoes . 	她 穿 著 深褐色 的 鞋子 。 
i 'm going to the park . 	我 去 公園 。 
he traveled all over the world . 	他 周遊 世界各地 。 
it 's supper time . 	吃 晚飯 的 時間 到 了 。 
english is an international language . 	英語 是 國際 語言 。 
my mother plays the piano well . 	我 的 母親 鋼琴彈 得 很 好 。 
she always takes care of her children . 	她 毫無間 斷 地 照顧 自己 的 孩子 。 
what do you plan to sell ? 	你 計劃 賣 甚麼 ？ 
read this now . 	現在 讀 這個 。 
it 's a waste of time and money . 	這 是 在 浪費 時間 和 金錢 。 
i ca n't say for sure . 	我 不 太 確定 。 
could you send it to this address ? 	你 能 把 它 送到 這個 地址 嗎 ？ 
i 'm looking forward to your visit . 	我 期待 著 您 的 光臨 。 
tom finally did something right . 	湯姆 最終 做 了 點 正確 的 事 。 
has something happened ? 	發生 了 什麼 事 嗎 ？ 
will it take long to recover ? 	要 很長 的 時間 才能 恢 復 嗎 ？ 
i bought a camera the other day . 	我前 幾天 買 了 一臺 照相 機 。 
i 'm sorry i did n't reply to you sooner . 	抱歉 ， 我 沒 有 早點 回覆 你 。 
it is easy to answer this question . 	回答 這個 問題 很 容易 。 
are you going to sing here ? 	你們 要 在 這裏 唱歌 嗎 ？ 
someone told me about that . 	有人 跟 我 說 這件 事 。 
he wei@@ gh@@ s a lot more than before . 	他 比 以前 重得 多 。 
the room is fully furnished . 	房間裡 傢俱 齊全 。 
how do you want your hair cut ? 	你 想 將頭 髮 剪成 怎樣 ？ 
do you have a cough ? 	你 咳嗽 嗎 ？ 
i did n't trust tom and he did n't trust me , either . 	我 不 信任 湯姆 而且 湯姆 也 不 信任 我 。 
i 've heard the french ver@@ sion of this song . 	我 聽 過 這 首歌 的 法語 版 。 
that was three days ago . 	這是 三天 之前 了 。 
the children are having fun in the park . 	孩子 們 在 公園 裏 玩耍 。 
jealousy made him do that . 	嫉妒 讓 他 那樣 做 。 
has the bell rung ? 	鐘響 過 了 嗎 ？ 
i smell gas . 	我聞 到 瓦斯 味 。 
i think i 'll go by bus . 	我 認為 我 要 坐 巴士 去 。 
let 's take a walk in the park . 	讓 我們 在 公園裡 散步 吧 。 
you look ten@@ se . 	你 看起來 很 緊張 。 
what time will you have breakfast ? 	你 什麼 時候 吃 早餐 ？ 
something is wrong with my watch . 	我 的 錶 出 了 毛病 。 
there 's only a little milk left . 	只 剩下 一點點 牛奶 了 。 
he had kept the secret to himself . 	他 保守 著 這個 祕密 。 
come on over to have a try . 	你 過來 試試 看 。 
she has att@@ ra@@ ctive eyes . 	她 有 一雙 迷人 的 眼睛 。 
i get you . 	我 瞭解 你 。 
children should obey their parents . 	孩子 應該 服 從 他們 的 父母 。 
i did nothing out of the ordinary . 	我 沒 做 不 尋常 的 事 。 
ho@@ p in . 	跳 進來 。 
do i have to do it right away ? 	我 必須 立刻 做 嗎 ？ 
she may be late , in which case we will wait . 	她 可能 遲到 ， 然後 我們 就要 等 。 
is this fish still alive ? 	這條 魚 還是 活 的 嗎 ？ 
i 'm not le@@ tting tom do this by himself . 	我 不會 讓 湯姆 獨自 去 做 。 
this box is too bul@@ k@@ y to carry . 	這個 箱子 太 笨重 了 無法 攜帶 。 
he had a large family to support . 	他 要 養活 一個 大家庭 。 
it 's a surprise . 	這是 一個 驚喜 。 
he threw a ball over the fence . 	他 把 球 扔過 了 柵欄 。 
i should have taken the money . 	我應 該 拿 那些 錢 的 。 
the school was est@@ ab@@ li@@ shed in 16@@ 50 . 	這所 學校 建於 1650 年 。 
he has no reason to be late . 	他 遲到 沒有 理由 。 
she managed to drive a car . 	她 成功 地開車 了 。 
did n't you lock up your car ? 	你 沒有 把 你 的 車上 鎖 嗎 ？ 
i had a lot of fun . 	我 玩 得 很 開心 。 
i 'm a stranger here myself . i 'm afraid i ca n't help you . 	我 對 這裡 不熟 。 恐怕 我 不能 幫 你 。 
is eating with chop@@ sti@@ cks difficult ? 	用 筷子 吃 飯 難 嗎 ？ 
keep on smiling . 	保持 微笑 。 
tom was caught driving without a license . 	Tom 被 抓 到 無照 駕駛 。 
he was n't the same as i thought he 'd be . 	他 跟 我 想 的 不 一樣 。 
the law should not be vio@@ lated . 	法律 不應 受到 侵犯 。 
we had a good time last night . 	我們 昨晚 玩得 很 開心 。 
i do n't want to fail my exams . 	我 不想 不 通過 考試 。 
i had to change clothes because what i was wearing was n't appro@@ priate for the situation . 	我 必須 要換 衣服 ， 因爲 我 現在 穿 的 衣服 不 適合 這個 環境 。 
really ? 	你 確定 ？ 
the potato was so hot that it burned my mouth . 	土豆 太熱 ， 以至於 燙 到 了 我 的 嘴 。 
we are looking forward to seeing you and your family . 	我們 很 期待 見到 您 和 您 的 家人 。 
i ca n't answer you now . 	我 現在 不能 回答 你 。 
she is good at playing tennis . 	她 擅長 打 網球 。 
this is a hospital . 	這是 醫院 。 
we 'll come back tomorrow . 	我們 明天 回來 。 
we 'll begin tomorrow morning . 	我們 明天 上午 開始 。 
would you like some scra@@ mb@@ led egg ? 	你 想要 來些 炒 蛋 嗎 ？ 
i came to war@@ n you not to do that . 	我來 警告 你別 那樣 做 。 
it is warmer today than yesterday . 	今天 比 昨天 暖和 。 
tom came a little earlier today than he usually does . 	湯姆 今天 來得 比 往常 要 早 一些 。 
it 's really hot here in the summer . 	這裏 夏天 非常 熱 。 
i a@@ woke to find it snowing . 	當我醒 來 時 ， 天正 下著雪 。 
spring is the best season to visit kyoto . 	春天 是 訪問 京都 最好 的 季節 。 
will you please show me the way ? 	請 你 告訴 我路 怎麼 走 好 嗎 ？ 
i 'm on my way . 	我 這 就 上路 。 
my father is healthy . 	父親 很 健康 。 
i have some good news for you . 	我 有 好消息 要 告訴 你 。 
tom did n't give me what i asked him for . 	湯姆 沒 給 我 我 跟 他 要 的 。 
there 's not a cloud in the sky . 	天上 沒有 雲 。 
who picked you for this mission ? 	誰 選 你 來 做 這個 任務 ？ 
i left my umbrella in the cab . 	我 把 我 的 傘忘 在 計程車 上 了 。 
all of a sudden , three dogs appeared in front of us . 	突然 之間 ， 三 隻 狗 出現 在 我們 面前 。 
i 'd better do it right now . 	我 馬上 做 比較 好 。 
did you enjoy yourself yesterday ? 	你 昨天 玩得 開心 嗎 ? 
that 's a book . 	那 是 一本 書 。 
i need to know tomorrow . 	我 明天 需要 知道 。 
i do n't blame you for doing that . 	我 不怪 你 那樣 做 。 
this is a dangerous mission . 	這是 個 危險 的 任務 。 
i have n't seen you for a while . 	我 好 一陣子 沒 看到 你 了 。 
the school needed a new teacher . 	學校 需要 一個 新 的 老師 。 
you can come at any time . 	你 隨時 可以 來 。 
let 's see what 's in the box . 	看看 我會 在 盒子 裡 找到 什麼 ? 
finally , he reached his goal . 	他 終於 達到 了 自己 的 目標 。 
tom is the tallest man i know . 	湯姆 是 我 所 知道 的 最高 的 人 。 
it is very hot here in the summer . 	這裏 夏天 非常 炎熱 。 
i ate tom 's sandwich . 	我 吃 了 湯姆 的 三明治 。 
i 'll show you the way . 	我會 為 你 帶路 。 
i wish tom could 've been there . 	我 希望 湯姆 能 在 那裏 。 
he is playing music . 	他 在 演奏 音樂 。 
a barber is a man who sha@@ ves and cu@@ ts men 's hair . 	理 髮 師是 為 男人 刮 鬍 子 和 剪 頭 髮 的 人 。 
after supper , i washed the dishes . 	晚飯 後 我 洗 了 碗碟 。 
tom went to boston to buy a painting . 	湯姆去 波士頓 買 一幅 畫 。 
move quietly . 	輕輕地 移動 。 
i took the children to school . 	我帶 孩子 們 去 上學 。 
she 's busy now and ca n't speak to you . 	她現 在 忙 ， 沒有 辦法 跟 你 們 說 話 。 
many asi@@ ans have english as a common language . 	許多亞洲 人以 英語 作為 共用 的 語言 。 
i like to eat . 	我 喜歡 吃 。 
it is too expensive . 	這 太貴 了 。 
i like bea@@ ns . 	我 喜歡 豆子 。 
there used to be a lot of fro@@ gs in this pond . 	以前 在 這個 池塘 裡有 許多 青蛙 。 
are you busy ? 	你 忙 嗎 ？ 
fini@@ shing the report by tomorrow is next to impossible . 	在 明天 前 完成 報告 幾乎 是 不 可能 的 。 
if you do n't understand , ask . 	如果 你 不 懂 ， 那 就 問 。 
he is good at playing tennis . 	他 打 網球 打得 很 好 。 
i 'll stop by your place on my way home . 	我 回家 路上 會 在 你 那裏 停下 。 
he played baseball after school . 	他 放學 後 打 棒球 。 
i had a feeling this might happen . 	我 早 有 一種 感覺 這 可能 會 發生 。 
can you wake me up at 7:00 tomorrow ? 	你 明天 早上 七點 可不可以 叫 我 起牀 。 
the soldier gave water to me . 	士兵 給了 我 水 。 
he came here ten minutes ago . 	他 十分 鐘前 到 這裡 。 
you can go to the b@@ all@@ park on this bus . 	坐 這個 公車 可以 到 球場 。 
i owe it you that i am still alive . 	多虧 了 你 ， 我 還 活着 。 
a@@ i stands for artificial intelligence . 	AI 代表 人工智能 。 
she is n't a good cook . 	她 不是 一個 好 廚師 。 
you do n't have to eat it . 	你 不必 吃 。 
